g_yr,g_cy,Geo_FIPS,g_id,I,g_st,t_h,t_h_as,t_h_bl,t_h_hi,t_h_mr,t_h_n_hi,t_h_na,t_h_nf,t_h_nh,t_h_nw,t_h_or,t_h_or_fm,t_h_or_nf,t_h_wa,t_h_wh,t_h_wh_fm,t_h_wh_nf,t_p,t_p_as,t_p_bl,t_p_hi,t_p_mr,t_p_na,t_p_nh,t_p_or,t_p_wh,t_u,t_u_oc,t_u_oc_oo,t_u_oc_ro,t_u_vc
2010,5,34005700102,34,80045.0,34,1052,7,45,17,8,1035,1,315,2,78,,,,974,,,,2638,32,109,61,46,4,3,24,2420,1118,1052,877,175,66
2010,5,34005700103,34,65429.0,34,1401,33,141,56,14,1345,5,672,2,245,,,,1156,,,,2839,76,303,154,67,7,3,40,2343,1519,1401,1026,375,118
2010,5,34005700104,34,47317.0,34,703,8,230,43,19,660,7,231,0,300,,,,403,,,,1921,28,664,182,74,12,0,80,1063,755,703,439,264,52
2010,5,34005700200,34,96848.0,34,1057,4,33,22,13,1035,1,302,0,73,,,,984,,,,2779,21,92,56,52,3,2,13,2596,1112,1057,827,230,55
2010,5,34005700303,34,64250.0,34,1107,28,190,41,17,1066,1,338,0,275,,,,832,,,,2897,88,514,148,79,2,0,48,2166,1187,1107,904,203,80
2010,5,34005700304,34,85000.0,34,881,8,23,19,5,862,0,204,0,55,,,,826,,,,2454,30,88,87,40,0,3,39,2254,907,881,830,51,26
2010,5,34005700305,34,97813.0,34,1762,38,46,32,15,1730,1,383,0,129,,,,1633,,,,4894,128,123,116,63,5,0,15,4560,1832,1762,1695,67,70
2010,5,34005700306,34,96250.0,34,864,13,13,17,6,847,1,136,0,52,,,,812,,,,2542,42,54,68,23,2,0,38,2383,892,864,837,27,28
2010,5,34005700307,34,101500.0,34,921,22,23,13,8,908,1,122,0,68,,,,853,,,,2782,82,76,59,39,4,0,13,2568,940,921,908,13,19
2010,5,34005700401,34,79569.0,34,783,8,6,14,9,769,0,246,0,35,,,,748,,,,2051,29,21,60,32,0,1,13,1955,816,783,694,89,33
2010,5,34005700402,34,78917.0,34,1283,11,11,37,16,1246,2,368,0,75,,,,1208,,,,3345,44,81,138,58,4,0,32,3126,1323,1283,1182,101,40
2010,5,34005700403,34,60694.0,34,1676,21,36,57,15,1619,1,587,0,125,,,,1551,,,,4438,96,139,206,50,1,1,64,4087,1763,1676,1231,445,87
2010,5,34005700405,34,67094.0,34,668,15,17,17,5,651,1,228,0,55,,,,613,,,,1643,43,35,65,28,1,0,23,1513,694,668,532,136,26
2010,5,34005700407,34,50266.0,34,2819,254,626,349,141,2470,9,1574,2,1317,,,,1502,,,,5529,648,1253,959,323,21,2,410,2872,3139,2819,339,2480,320
2010,5,34005700408,34,39745.0,34,1296,99,177,78,27,1218,3,864,1,376,,,,920,,,,2125,220,297,163,57,4,1,59,1487,1451,1296,161,1135,155
2010,5,34005700501,34,90855.0,34,2133,62,159,62,33,2071,4,590,2,311,,,,1822,,,,5483,219,428,242,142,6,2,61,4625,2228,2133,1555,578,95
2010,5,34005700502,34,88125.0,34,816,24,31,27,7,789,1,231,0,92,,,,724,,,,2215,83,87,112,38,2,0,35,1970,860,816,641,175,44
2010,5,34005700503,34,118676.0,34,1341,28,198,46,34,1295,2,296,1,301,,,,1040,,,,3713,91,473,146,129,8,2,34,2976,1402,1341,1111,230,61
2010,5,34005700504,34,97143.0,34,1130,14,71,25,8,1105,0,329,0,117,,,,1013,,,,3136,61,196,89,48,0,1,17,2813,1219,1130,819,311,89
2010,5,34005700505,34,228000.0,34,2030,212,53,33,8,1997,0,380,0,305,,,,1725,,,,6179,790,147,132,90,2,0,21,5129,2153,2030,1768,262,123
2010,5,34005700602,34,94167.0,34,2316,118,194,72,35,2244,4,579,2,424,,,,1892,,,,6505,412,565,277,183,10,5,104,5226,2389,2316,2140,176,73
2010,5,34005700603,34,71980.0,34,2120,55,335,112,43,2008,4,605,1,581,,,,1539,,,,5621,172,761,352,171,14,1,270,4232,2296,2120,1268,852,176
2010,5,34005700605,34,87656.0,34,1712,26,127,37,12,1675,5,330,0,222,,,,1490,,,,4770,99,290,150,56,9,1,85,4230,1757,1712,1351,361,45
2010,5,34005700701,34,66307.0,34,1222,7,49,69,57,1153,3,391,0,191,,,,1031,,,,3205,28,148,281,194,13,0,168,2654,1259,1222,876,346,37
2010,5,34005700702,34,53934.0,34,886,10,64,79,21,807,2,288,0,192,,,,694,,,,2451,31,186,317,119,7,0,216,1892,961,886,511,375,75
2010,5,34005700703,34,55929.0,34,851,6,63,67,25,784,0,253,1,174,,,,677,,,,2423,18,182,318,99,1,4,185,1934,927,851,554,297,76
2010,5,34005700800,34,81531.0,34,1755,25,197,47,24,1708,5,514,1,291,,,,1464,,,,4283,80,470,152,122,20,5,40,3546,1853,1755,1446,309,98
2010,5,34005700900,34,53112.0,34,1002,6,284,57,28,945,3,331,0,364,,,,638,,,,2577,20,770,236,125,4,0,69,1589,1086,1002,686,316,84
2010,5,34005701001,34,48393.0,34,2288,49,672,188,104,2100,8,1029,1,989,,,,1299,,,,4862,153,1364,554,258,19,2,244,2822,2484,2288,1205,1083,196
2010,5,34005701002,34,76750.0,34,1395,32,360,104,40,1291,3,330,0,560,,,,835,,,,4019,130,1062,416,180,11,0,333,2303,1442,1395,1067,328,47
2010,5,34005701102,34,90795.0,34,1917,94,479,96,34,1821,4,607,1,694,,,,1223,,,,5516,331,1224,384,182,9,1,94,3675,1988,1917,1546,371,71
2010,5,34005701103,34,105744.0,34,2075,129,627,112,55,1963,2,388,1,909,,,,1166,,,,6371,490,1789,456,255,6,1,146,3684,2125,2075,1798,277,50
2010,5,34005701104,34,52813.0,34,1708,81,524,99,42,1609,3,486,2,754,,,,954,,,,4556,333,1299,317,142,9,5,177,2591,1785,1708,1123,585,77
2010,5,34005701105,34,84435.0,34,2097,109,646,121,50,1976,3,571,1,906,,,,1191,,,,6151,436,2010,436,184,11,2,127,3381,2207,2097,1647,450,110
2010,5,34005701201,34,71083.0,34,1131,19,297,46,18,1085,0,334,0,370,,,,761,,,,2967,64,862,186,86,2,0,47,1906,1193,1131,925,206,62
2010,5,34005701203,34,58958.0,34,752,14,177,34,7,718,1,252,1,230,,,,522,,,,1857,46,419,103,44,5,3,31,1309,788,752,489,263,36
2010,5,34005701204,34,45024.0,34,1048,11,501,45,32,1003,2,462,0,574,,,,474,,,,2818,41,1521,193,150,5,0,78,1023,1203,1048,379,669,155
2010,5,34005701205,34,43040.0,34,927,12,188,46,20,881,2,373,0,262,,,,665,,,,2278,50,470,163,73,6,1,71,1607,1039,927,595,332,112
2010,5,34005701301,34,67348.0,34,1857,43,298,58,41,1799,1,691,1,431,,,,1426,,,,4426,127,746,232,188,7,2,72,3284,1998,1857,1297,560,141
2010,5,34005701302,34,77650.0,34,1047,24,46,21,14,1026,3,355,0,101,,,,946,,,,2649,101,129,93,57,6,0,10,2346,1091,1047,870,177,44
2010,5,34005701303,34,92688.0,34,1871,108,208,74,28,1797,4,444,2,413,,,,1458,,,,5034,382,606,251,125,10,5,39,3867,1964,1871,1687,184,93
2010,5,34005701401,34,117331.0,34,2232,155,268,97,22,2135,6,418,1,530,,,,1702,,,,6495,579,840,388,167,11,5,45,4848,2305,2232,2077,155,73
2010,5,34005701402,34,51911.0,34,1169,22,23,16,2,1153,1,531,0,63,,,,1106,,,,2049,78,50,40,5,3,0,8,1905,1224,1169,1127,42,55
2010,5,34005701502,34,58892.0,34,1549,69,102,79,15,1470,4,515,0,260,,,,1289,,,,3724,234,212,227,62,13,0,64,3139,1664,1549,1032,517,115
2010,5,34005701700,34,66885.0,34,1859,34,171,75,21,1784,3,937,1,299,,,,1560,,,,3924,107,397,228,88,8,1,46,3277,2014,1859,981,878,155
2010,5,34005702101,34,50645.0,34,892,17,149,119,30,773,7,123,5,314,,,,578,,,,2887,69,468,419,212,9,25,126,1978,1391,892,4,888,499
2010,5,34005702203,34,55657.0,34,1357,38,444,171,44,1186,7,517,0,676,,,,681,,,,3309,108,1073,477,176,12,1,163,1776,1465,1357,852,505,108
2010,5,34005702204,34,43571.0,34,638,7,146,85,17,553,3,154,1,251,,,,387,,,,2289,26,604,366,119,4,1,134,1401,700,638,370,268,62
2010,5,34005702206,34,56173.0,34,714,7,86,49,25,665,3,248,0,168,,,,546,,,,1875,23,226,164,81,6,1,40,1498,772,714,562,152,58
2010,5,34005702207,34,44076.0,34,1481,51,272,118,43,1363,5,582,3,476,,,,1005,,,,3682,117,694,380,235,11,6,95,2524,1595,1481,1091,390,114
2010,5,34005702208,34,82212.0,34,2413,49,365,175,70,2238,8,518,5,643,,,,1770,,,,7064,187,1107,721,332,15,8,159,5256,2574,2413,2203,210,161
2010,5,34005702209,34,61214.0,34,1065,26,167,91,38,974,7,269,1,309,,,,756,,,,3065,94,481,302,182,14,1,38,2255,1139,1065,906,159,74
2010,5,34005702210,34,43777.0,34,1756,87,423,184,66,1572,13,497,1,730,,,,1026,,,,4863,210,1192,671,316,32,2,169,2942,1859,1756,1316,440,103
2010,5,34005702300,34,65833.0,34,581,17,85,52,19,529,1,177,0,161,,,,420,,,,1409,46,215,179,53,3,0,44,1048,642,581,387,194,61
2010,5,34005702400,34,100586.0,34,1162,20,44,30,10,1132,1,221,0,106,,,,1056,,,,3414,87,130,127,56,7,0,41,3093,1217,1162,1062,100,55
2010,5,34005702500,34,69375.0,34,2281,83,395,149,47,2132,9,642,2,663,,,,1618,,,,6069,272,1030,503,205,21,4,100,4437,2380,2281,1556,725,99
2010,5,34005702601,34,73407.0,34,1566,27,240,116,34,1450,5,484,2,407,,,,1159,,,,4058,71,710,379,158,12,5,108,2994,1655,1566,1258,308,89
2010,5,34005702603,34,41806.0,34,852,10,160,70,28,782,3,335,0,258,,,,594,,,,2316,27,455,262,143,6,1,87,1597,968,852,402,450,116
2010,5,34005702700,34,96032.0,34,3195,167,791,224,66,2971,7,766,2,1218,,,,1977,,,,8813,608,2243,779,367,17,3,199,5376,3291,3195,2945,250,96
2010,5,34005702801,34,82448.0,34,713,8,528,42,25,671,2,150,0,593,,,,120,,,,2077,31,1554,178,81,8,1,66,336,746,713,667,46,33
2010,5,34005702802,34,75024.0,34,1128,19,808,75,24,1053,8,248,2,911,,,,217,,,,3390,67,2482,265,134,22,4,88,593,1177,1128,1042,86,49
2010,5,34005702803,34,67961.0,34,1343,11,959,83,42,1260,5,282,0,1078,,,,265,,,,3936,38,2892,345,171,15,0,112,708,1406,1343,1235,108,63
2010,5,34005702804,34,65250.0,34,971,10,678,57,25,914,3,246,0,755,,,,216,,,,2647,37,1918,222,101,7,0,73,511,1004,971,906,65,33
2010,5,34005702805,34,66935.0,34,1254,28,871,84,33,1170,5,250,1,1006,,,,248,,,,3812,116,2747,319,154,17,1,130,647,1314,1254,1146,108,60
2010,5,34005702806,34,65591.0,34,1184,21,835,93,40,1091,5,230,0,966,,,,218,,,,3792,62,2718,396,203,21,1,138,649,1269,1184,1046,138,85
2010,5,34005702807,34,54839.0,34,1223,32,814,101,43,1122,2,427,0,969,,,,254,,,,3184,106,2117,345,164,5,1,132,659,1292,1223,766,457,69
2010,5,34005702808,34,61033.0,34,1082,27,756,72,38,1010,5,215,1,878,,,,204,,,,3356,108,2403,293,158,9,1,140,537,1154,1082,975,107,72
2010,5,34005702809,34,61033.0,34,615,5,454,28,19,587,1,256,0,499,,,,116,,,,1402,14,1085,72,55,3,0,31,214,653,615,478,137,38
2010,5,34005702810,34,98833.0,34,459,5,328,27,10,432,1,103,0,357,,,,102,,,,1405,16,1047,116,64,2,0,31,245,486,459,431,28,27
2010,5,34005702811,34,90662.0,34,912,8,692,42,33,870,5,190,0,766,,,,146,,,,2628,40,2044,186,112,8,1,47,376,941,912,868,44,29
2010,5,34005702905,34,81875.0,34,1714,98,127,55,13,1659,2,645,1,290,,,,1424,,,,4120,244,317,177,86,9,1,32,3431,1834,1714,1145,569,120
2010,5,34005702906,34,92083.0,34,645,36,29,18,6,627,1,84,0,89,,,,556,,,,2140,131,153,79,31,1,2,19,1803,671,645,614,31,26
2010,5,34005702907,34,72679.0,34,1234,28,27,16,10,1218,2,367,0,81,,,,1153,,,,2935,77,70,66,38,5,0,7,2738,1267,1234,1191,43,33
2010,5,34005702908,34,67143.0,34,1983,60,48,22,7,1961,2,744,1,142,,,,1841,,,,4423,183,140,104,34,3,4,15,4044,2076,1983,1901,82,93
2010,5,34005702909,34,96104.0,34,2507,208,255,79,33,2428,2,800,1,567,,,,1940,,,,6191,666,689,285,159,5,2,58,4612,2565,2507,2286,221,58
2010,5,34005702910,34,110602.0,34,2104,110,199,78,29,2026,3,607,0,411,,,,1693,,,,5585,403,508,269,142,7,0,88,4437,2167,2104,1779,325,63
2010,5,34005702913,34,70089.0,34,2437,179,343,114,56,2323,3,1388,0,672,,,,1765,,,,4401,464,705,265,144,4,1,56,3027,2571,2437,1622,815,134
2010,5,34005702914,34,91741.0,34,1506,71,120,58,17,1448,1,288,0,260,,,,1246,,,,4205,244,363,214,106,3,0,46,3443,1558,1506,1395,111,52
2010,5,34005702915,34,74135.0,34,1731,102,298,87,42,1644,9,594,5,525,,,,1206,,,,4262,303,755,294,175,25,6,59,2939,1811,1731,1273,458,80
2010,5,34005702917,34,113826.0,34,818,57,87,19,12,799,0,298,0,171,,,,647,,,,1911,180,197,67,38,0,0,14,1482,834,818,736,82,16
2010,5,34005702918,34,88977.0,34,859,48,82,32,14,827,1,434,1,176,,,,683,,,,1691,145,164,87,59,5,1,24,1293,895,859,720,139,36
2010,5,34005703000,34,85804.0,34,2239,71,154,78,25,2161,5,513,0,328,,,,1911,,,,6110,249,458,310,130,6,0,87,5180,2305,2239,2030,209,66
2010,5,34005703102,34,136607.0,34,884,34,74,21,10,863,0,135,0,139,,,,745,,,,2673,126,251,78,40,0,2,8,2246,918,884,794,90,34
2010,5,34005703103,34,65382.0,34,1955,88,562,149,64,1806,5,770,0,833,,,,1122,,,,4768,279,1423,382,227,20,0,144,2675,2043,1955,972,983,88
2010,5,34005703104,34,96454.0,34,1701,48,248,72,28,1629,4,398,1,385,,,,1316,,,,5118,186,704,276,177,10,3,43,3995,1758,1701,1478,223,57
2010,5,34005703201,34,72097.0,34,1411,20,29,29,15,1382,5,368,1,95,,,,1316,,,,3687,72,83,96,77,7,1,29,3418,1493,1411,1262,149,82
2010,5,34005703202,34,85900.0,34,930,10,12,22,7,908,0,168,0,51,,,,879,,,,2665,38,42,90,47,2,0,19,2517,975,930,839,91,45
2010,5,34005703203,34,34877.0,34,2405,13,58,23,9,2382,2,1170,0,103,,,,2302,,,,4112,29,106,39,18,3,0,3,3953,2556,2405,2260,145,151
2010,5,34005703600,34,95088.0,34,2374,15,30,34,10,2340,3,397,2,94,,,,2280,,,,6946,48,96,192,74,5,4,65,6654,2444,2374,2219,155,70
2010,5,34005703700,34,103500.0,34,2169,10,15,29,15,2140,3,343,0,68,,,,2101,,,,6493,38,60,149,75,13,1,17,6289,2228,2169,2078,91,59
2010,5,34005703801,34,114157.0,34,2486,35,41,39,16,2447,6,534,0,135,,,,2351,,,,6998,131,119,184,102,24,0,30,6592,2637,2486,2083,403,151
2010,5,34005703802,34,83125.0,34,1633,25,54,40,15,1593,2,631,0,132,,,,1501,,,,3894,78,116,155,64,7,0,66,3563,1755,1633,1018,615,122
2010,5,34005703803,34,92368.0,34,1758,26,9,26,5,1732,1,352,0,65,,,,1693,,,,4897,87,27,128,49,1,0,21,4712,1796,1758,1684,74,38
2010,5,34005703804,34,133529.0,34,2400,45,27,26,16,2374,1,305,1,113,,,,2287,,,,7244,171,91,133,100,4,6,13,6859,2464,2400,2306,94,64
2010,5,34005703900,34,102083.0,34,1483,7,5,18,5,1465,2,297,0,35,,,,1448,,,,4146,40,19,70,29,7,0,16,4035,1543,1483,1398,85,60
2010,5,34005704004,34,58947.0,34,1652,113,102,76,27,1576,2,720,0,308,,,,1344,,,,3701,321,206,230,76,5,1,67,3025,1787,1652,878,774,135
2010,5,34005704005,34,84583.0,34,1520,87,71,36,14,1484,0,520,0,205,,,,1315,,,,3757,247,170,122,55,3,0,40,3242,1575,1520,1158,362,55
2010,5,34005704006,34,97174.0,34,906,89,61,27,11,879,1,302,0,184,,,,722,,,,2228,270,177,110,56,3,0,38,1684,948,906,780,126,42
2010,5,34005704007,34,62375.0,34,1403,27,19,29,11,1374,3,508,0,85,,,,1318,,,,3722,89,75,116,39,9,0,31,3479,1463,1403,982,421,60
2010,5,34005704008,34,102955.0,34,1965,73,40,28,21,1937,1,457,0,160,,,,1805,,,,5283,249,99,118,74,7,1,16,4837,2058,1965,1414,551,93
2010,5,34005704009,34,73160.0,34,1913,84,120,60,26,1853,3,732,0,284,,,,1629,,,,4569,253,291,177,113,7,0,47,3858,2003,1913,1054,859,90
2010,5,34005704011,34,106431.0,34,1033,19,25,14,7,1019,0,156,0,65,,,,968,,,,3137,83,75,54,28,1,0,8,2942,1063,1033,998,35,30
2010,5,34005704012,34,83914.0,34,2583,58,93,62,20,2521,2,1020,0,230,,,,2353,,,,5888,140,235,209,108,9,2,34,5360,2658,2583,2260,323,75
2010,5,34005704013,34,109750.0,34,1746,104,73,35,21,1711,0,234,1,232,,,,1514,,,,5398,351,212,180,127,0,4,39,4665,1776,1746,1694,52,30
2010,5,34005704014,34,122212.0,34,2899,242,142,69,22,2830,4,659,1,471,,,,2428,,,,7855,801,370,226,119,10,1,37,6517,2972,2899,2505,394,73
2010,5,34005704200,34,92558.0,34,2830,265,301,115,47,2715,2,627,1,713,,,,2117,,,,8183,978,1072,472,237,17,7,118,5754,2917,2830,2433,397,87
2010,5,34005704302,34,117337.0,34,1523,177,85,44,17,1479,2,225,0,315,,,,1208,,,,4616,620,289,217,95,7,1,20,3584,1578,1523,1438,85,55
2010,5,34005704500,34,73277.0,34,2165,50,169,157,40,2008,8,726,3,407,,,,1758,,,,5480,121,395,586,183,19,10,256,4496,2287,2165,1516,649,122
2010,5,34005704600,34,54209.0,34,1038,16,300,143,37,895,4,375,1,474,,,,564,,,,3162,42,1038,569,188,17,1,214,1662,1238,1038,657,381,200
2010,5,34005704700,34,68804.0,34,1254,5,7,33,3,1221,1,310,0,47,,,,1207,,,,3918,27,162,193,36,3,0,38,3652,1365,1254,1040,214,111
2010,5,34005704801,34,78723.0,34,805,21,142,71,32,734,3,182,4,257,,,,548,,,,3122,67,702,465,161,15,18,136,2023,887,805,220,585,82
2010,5,34005704802,34,88348.0,34,221,6,41,23,9,198,4,60,3,82,,,,139,,,,5318,99,2007,1262,165,44,5,356,2642,267,221,2,219,46
2010,5,34005981802,34,107500.0,34,16,0,1,1,0,15,0,3,0,2,,,,14,,,,3083,23,1953,790,136,32,1,366,572,23,16,15,1,7
2010,5,34005982111,34,53750.0,34,134,5,22,12,7,122,2,11,0,43,,,,91,,,,823,29,134,87,53,8,0,14,585,144,134,2,132,10
2010,7,34007600200,34,38400.0,34,706,3,469,231,18,475,3,209,1,678,,,,28,,,,2131,11,1326,838,71,12,4,428,279,972,706,294,412,266
2010,7,34007600400,34,22986.0,34,1025,4,568,431,34,594,8,286,0,997,,,,28,,,,3237,9,1685,1516,108,25,0,890,520,1425,1025,358,667,400
2010,7,34007600700,34,37788.0,34,476,0,164,301,14,175,3,158,0,452,,,,24,,,,1475,1,454,1016,60,8,0,598,354,531,476,203,273,55
2010,7,34007600800,34,14570.0,34,1747,7,659,1117,59,630,17,716,0,1717,,,,30,,,,5053,23,1789,3376,204,52,0,2073,912,1940,1747,448,1299,193
2010,7,34007600900,34,20000.0,34,1299,4,410,859,57,440,9,273,1,1240,,,,59,,,,4456,18,1273,3186,234,33,3,1931,964,1392,1299,365,934,93
2010,7,34007601000,34,38015.0,34,1667,13,421,1144,75,523,11,396,0,1548,,,,119,,,,5624,61,1264,4191,288,39,0,2381,1591,1830,1667,911,756,163
2010,7,34007601101,34,38567.0,34,864,62,231,557,30,307,7,188,1,845,,,,19,,,,3268,251,739,2277,144,26,4,1448,656,955,864,357,507,91
2010,7,34007601102,34,29477.0,34,1641,149,517,932,52,709,13,414,1,1574,,,,67,,,,5567,630,1546,3354,220,47,7,2022,1095,1732,1641,750,891,91
2010,7,34007601200,34,32608.0,34,1980,66,861,921,72,1059,18,446,1,1829,,,,151,,,,6660,234,2451,3617,265,50,5,2179,1476,2112,1980,1087,893,132
2010,7,34007601300,34,23611.0,34,1597,17,750,823,62,774,21,470,0,1565,,,,32,,,,5184,57,2168,2972,210,55,0,1773,921,1873,1597,562,1035,276
2010,7,34007601400,34,30208.0,34,1521,8,1342,153,31,1368,13,457,1,1504,,,,17,,,,4494,29,3825,615,114,42,4,327,153,1815,1521,846,675,294
2010,7,34007601500,34,26449.0,34,2138,9,1553,571,58,1567,10,717,0,2084,,,,54,,,,6058,23,4307,1831,209,31,5,939,544,2589,2138,664,1474,451
2010,7,34007601600,34,28161.0,34,800,3,666,129,18,671,7,205,0,791,,,,9,,,,2316,8,1806,520,66,20,0,256,160,936,800,281,519,136
2010,7,34007601700,34,16276.0,34,1166,7,817,315,20,851,8,433,0,1120,,,,46,,,,2951,15,1926,1009,73,15,0,552,370,1303,1166,161,1005,137
2010,7,34007601800,34,27896.0,34,428,25,247,113,17,315,1,132,0,386,,,,42,,,,1291,84,672,470,53,2,0,284,196,608,428,202,226,180
2010,7,34007601900,34,16300.0,34,999,3,737,249,19,750,7,271,0,981,,,,18,,,,2879,4,2035,854,84,24,1,540,191,1100,999,375,624,101
2010,7,34007602000,34,32635.0,34,2245,15,1286,615,63,1630,13,644,2,1907,,,,338,,,,6799,38,3929,2256,263,52,10,1304,1203,2565,2245,1054,1191,320
2010,7,34007602503,34,49881.0,34,834,35,426,243,21,591,6,191,1,706,,,,128,,,,2567,160,1250,914,98,19,5,467,568,872,834,709,125,38
2010,7,34007602601,34,66179.0,34,928,83,212,148,20,780,3,234,2,451,,,,477,,,,2684,336,616,591,83,9,3,224,1413,966,928,823,105,38
2010,7,34007602602,34,54873.0,34,998,69,346,235,34,763,4,294,0,656,,,,342,,,,2883,296,976,865,141,11,0,385,1074,1039,998,727,271,41
2010,7,34007602901,34,71599.0,34,1874,88,263,173,32,1701,4,556,0,544,,,,1330,,,,4806,297,690,588,120,16,0,236,3447,1963,1874,1663,211,89
2010,7,34007602902,34,55054.0,34,1228,19,286,220,25,1008,4,369,0,530,,,,698,,,,3220,77,729,657,118,10,0,299,1987,1259,1228,863,365,31
2010,7,34007603001,34,75792.0,34,1320,46,148,143,27,1177,4,334,0,351,,,,969,,,,3726,210,461,572,102,9,1,243,2700,1385,1320,1122,198,65
2010,7,34007603002,34,56164.0,34,1504,137,429,496,43,1008,8,330,1,1056,,,,448,,,,5012,590,1380,2020,227,45,1,1201,1568,1581,1504,1173,331,77
2010,7,34007603100,34,64057.0,34,1574,28,196,143,24,1431,5,607,2,378,,,,1196,,,,3821,87,497,444,126,14,2,169,2926,1688,1574,961,613,114
2010,7,34007603200,34,71789.0,34,2821,187,279,213,51,2608,6,1093,3,714,,,,2107,,,,7055,572,702,796,204,20,5,322,5230,3073,2821,1887,934,252
2010,7,34007603301,34,61178.0,34,2256,329,218,145,37,2111,3,796,2,716,,,,1540,,,,5660,1039,440,463,155,5,2,161,3858,2476,2256,1333,923,220
2010,7,34007603302,34,89474.0,34,2335,173,135,77,27,2258,4,644,0,409,,,,1926,,,,6072,625,355,297,145,7,0,80,4860,2411,2335,2014,321,76
2010,7,34007603303,34,41250.0,34,1307,103,105,53,14,1254,0,698,0,270,,,,1037,,,,2703,311,222,167,39,0,0,70,2061,1367,1307,518,789,60
2010,7,34007603400,34,84464.0,34,2596,275,183,105,34,2491,4,746,0,590,,,,2006,,,,6920,907,485,354,163,14,1,80,5270,2967,2596,2040,556,371
2010,7,34007603501,34,110040.0,34,2304,359,195,51,27,2253,2,546,0,628,,,,1676,,,,6237,1145,555,185,126,5,0,44,4362,2388,2304,1902,402,84
2010,7,34007603503,34,127857.0,34,1609,156,43,22,11,1587,0,160,0,231,,,,1378,,,,4747,501,141,110,82,0,0,24,3999,1653,1609,1584,25,44
2010,7,34007603504,34,108214.0,34,954,91,49,28,5,926,0,176,0,172,,,,782,,,,2690,276,144,122,54,1,0,13,2202,990,954,910,44,36
2010,7,34007603505,34,78409.0,34,1201,120,75,54,15,1147,1,236,0,260,,,,941,,,,3459,426,228,218,79,5,0,47,2674,1234,1201,1134,67,33
2010,7,34007603506,34,108269.0,34,2138,282,62,44,16,2094,2,293,0,401,,,,1737,,,,6379,945,221,189,104,4,0,37,5068,2198,2138,2023,115,60
2010,7,34007603507,34,111393.0,34,2701,314,87,46,38,2655,3,839,1,486,,,,2215,,,,7081,926,271,149,132,10,2,40,5700,2827,2701,2172,529,126
2010,7,34007603601,34,81625.0,34,1422,54,88,45,9,1377,1,504,0,191,,,,1231,,,,3616,172,271,192,73,3,0,38,3059,1501,1422,1284,138,79
2010,7,34007603602,34,102125.0,34,909,17,6,16,5,893,0,145,0,43,,,,866,,,,2498,66,21,57,33,2,0,11,2365,925,909,894,15,16
2010,7,34007603603,34,101771.0,34,877,24,15,17,8,860,1,188,0,62,,,,815,,,,2387,88,54,89,44,1,0,14,2186,894,877,845,32,17
2010,7,34007603700,34,60435.0,34,1452,87,106,159,22,1293,1,526,0,362,,,,1090,,,,3541,305,250,617,96,1,3,321,2565,1548,1452,971,481,96
2010,7,34007603800,34,100192.0,34,1970,20,17,35,12,1935,0,564,0,78,,,,1892,,,,5173,72,48,155,66,5,0,37,4945,2034,1970,1684,286,64
2010,7,34007603901,34,66644.0,34,2170,55,18,42,19,2128,2,883,0,133,,,,2037,,,,4874,155,45,155,69,5,0,39,4561,2241,2170,1420,750,71
2010,7,34007603902,34,58750.0,34,1431,30,36,43,8,1388,3,709,0,115,,,,1316,,,,2940,68,66,122,38,7,0,47,2714,1506,1431,658,773,75
2010,7,34007604100,34,37361.0,34,917,74,318,279,33,638,10,217,1,675,,,,242,,,,2978,289,999,1140,141,21,1,688,839,1016,917,595,322,99
2010,7,34007604200,34,71563.0,34,1501,26,114,111,15,1390,6,705,0,262,,,,1239,,,,3387,79,291,400,100,13,0,183,2721,1596,1501,785,716,95
2010,7,34007604300,34,62010.0,34,1683,26,63,62,16,1621,4,807,0,163,,,,1520,,,,3687,58,126,212,100,9,0,49,3345,1832,1683,1116,567,149
2010,7,34007604400,34,75813.0,34,1337,20,22,47,6,1290,0,484,0,93,,,,1244,,,,3207,59,75,157,34,5,0,45,2989,1384,1337,998,339,47
2010,7,34007604600,34,53320.0,34,957,15,47,55,6,902,1,461,0,116,,,,841,,,,2107,54,84,142,43,4,1,34,1887,1055,957,533,424,98
2010,7,34007604700,34,82067.0,34,768,5,7,17,6,751,0,257,0,35,,,,733,,,,1931,19,16,75,21,5,0,26,1844,792,768,675,93,24
2010,7,34007605100,34,65048.0,34,893,8,5,19,7,874,0,253,0,36,,,,857,,,,2394,34,20,83,34,2,0,9,2295,959,893,754,139,66
2010,7,34007605200,34,58701.0,34,1035,26,32,47,9,988,1,346,0,112,,,,923,,,,2617,95,120,214,44,10,0,72,2276,1184,1035,857,178,149
2010,7,34007605300,34,59143.0,34,759,9,32,31,9,728,2,243,0,79,,,,680,,,,1955,43,104,123,48,2,0,40,1718,806,759,585,174,47
2010,7,34007605400,34,62463.0,34,1102,5,10,31,6,1071,0,421,0,50,,,,1052,,,,2652,14,25,118,27,0,0,45,2541,1160,1102,883,219,58
2010,7,34007605602,34,80455.0,34,1108,3,16,22,7,1086,0,361,0,46,,,,1062,,,,2827,12,26,88,34,4,0,12,2739,1157,1108,846,262,49
2010,7,34007605700,34,74671.0,34,1449,19,31,44,11,1405,1,531,1,98,,,,1351,,,,3582,56,74,141,46,1,1,41,3363,1542,1449,1043,406,93
2010,7,34007605800,34,83345.0,34,1152,11,11,17,3,1135,1,350,0,41,,,,1111,,,,2897,53,38,70,32,5,0,19,2750,1195,1152,1009,143,43
2010,7,34007605900,34,87344.0,34,1001,7,9,17,6,984,1,284,1,39,,,,962,,,,2573,22,11,55,30,4,4,7,2495,1039,1001,820,181,38
2010,7,34007606000,34,100500.0,34,844,7,19,19,9,825,2,341,0,54,,,,790,,,,2003,23,35,73,39,3,1,14,1888,925,844,513,331,81
2010,7,34007606100,34,114625.0,34,853,11,5,25,5,828,0,220,0,45,,,,808,,,,2339,32,9,76,31,0,0,5,2262,883,853,690,163,30
2010,7,34007606200,34,103510.0,34,1544,31,7,16,9,1528,0,446,0,64,,,,1480,,,,3965,96,28,56,62,1,0,11,3767,1604,1544,1322,222,60
2010,7,34007606300,34,98639.0,34,970,13,29,20,8,950,0,387,0,68,,,,902,,,,2237,50,67,56,33,0,0,19,2068,1018,970,676,294,48
2010,7,34007606400,34,180893.0,34,1072,10,9,13,3,1059,0,205,0,35,,,,1037,,,,3057,37,25,60,29,3,0,15,2948,1132,1072,968,104,60
2010,7,34007606500,34,54838.0,34,1103,8,996,36,25,1067,8,341,0,1066,,,,37,,,,2945,42,2616,129,95,19,0,49,124,1174,1103,796,307,71
2010,7,34007606600,34,90588.0,34,986,12,39,57,11,929,4,356,0,118,,,,868,,,,2288,44,88,166,63,9,0,45,2039,1051,986,616,370,65
2010,7,34007606700,34,51225.0,34,2002,24,145,71,19,1931,5,828,0,251,,,,1751,,,,4695,74,270,214,72,7,0,57,4215,2107,2002,1237,765,105
2010,7,34007606800,34,64129.0,34,1473,113,20,80,22,1393,3,438,0,237,,,,1236,,,,3942,451,47,308,69,8,1,104,3262,1524,1473,1190,283,51
2010,7,34007607000,34,48952.0,34,1941,32,43,111,15,1830,2,690,1,198,,,,1743,,,,4677,117,77,385,78,6,4,200,4195,2016,1941,1149,792,75
2010,7,34007607100,34,67625.0,34,1447,11,19,42,9,1405,3,399,0,84,,,,1363,,,,3902,49,61,185,50,6,0,70,3666,1490,1447,1291,156,43
2010,7,34007607200,34,45323.0,34,1923,57,160,98,26,1825,7,756,0,338,,,,1585,,,,4566,174,339,331,89,19,0,115,3830,2058,1923,1098,825,135
2010,7,34007607300,34,59528.0,34,1709,29,311,93,22,1616,5,562,0,442,,,,1267,,,,4339,81,793,340,112,13,2,96,3242,1849,1709,1255,454,140
2010,7,34007607401,34,54706.0,34,1158,51,240,75,27,1083,1,400,0,381,,,,777,,,,2947,196,582,266,117,2,0,104,1946,1228,1158,809,349,70
2010,7,34007607402,34,54306.0,34,868,34,147,44,11,824,2,281,0,233,,,,635,,,,2204,113,396,156,71,2,1,54,1567,930,868,683,185,62
2010,7,34007607502,34,89755.0,34,2337,173,85,38,21,2299,4,804,1,318,,,,2019,,,,6017,597,345,169,114,8,4,40,4909,2456,2337,1824,513,119
2010,7,34007607503,34,97167.0,34,2318,389,174,52,27,2266,1,564,3,641,,,,1677,,,,6540,1302,509,180,146,7,4,42,4530,2444,2318,1803,515,126
2010,7,34007607504,34,152273.0,34,1183,103,71,26,10,1157,0,115,0,209,,,,974,,,,3692,360,194,90,59,0,0,16,3063,1207,1183,1152,31,24
2010,7,34007607505,34,126034.0,34,1552,193,128,36,16,1516,2,229,1,370,,,,1182,,,,4749,675,394,158,110,6,1,21,3542,1582,1552,1505,47,30
2010,7,34007607506,34,74180.0,34,1320,284,191,60,30,1260,1,576,0,559,,,,761,,,,3030,855,442,177,112,8,0,61,1552,1444,1320,674,646,124
2010,7,34007607507,34,45486.0,34,2760,366,351,92,55,2668,6,1747,0,860,,,,1900,,,,5103,911,650,224,147,15,2,66,3312,3127,2760,760,2000,367
2010,7,34007607600,34,74444.0,34,786,10,18,23,8,763,0,160,0,57,,,,729,,,,2274,53,49,93,46,0,0,20,2106,809,786,726,60,23
2010,7,34007607701,34,42645.0,34,2352,66,1105,611,63,1741,19,954,0,1802,,,,550,,,,6030,180,2414,2254,232,47,0,1280,1877,2790,2352,565,1787,438
2010,7,34007607702,34,49077.0,34,1681,40,494,158,29,1523,8,784,2,707,,,,974,,,,3910,108,1149,591,151,19,2,271,2210,1783,1681,785,896,102
2010,7,34007607801,34,40470.0,34,2521,70,1009,198,68,2323,5,1230,0,1309,,,,1212,,,,5368,151,2161,614,193,8,2,214,2639,2760,2521,942,1579,239
2010,7,34007607802,34,62204.0,34,872,18,131,52,12,820,1,246,0,208,,,,664,,,,2305,54,380,214,67,4,0,57,1743,918,872,683,189,46
2010,7,34007607900,34,87083.0,34,727,4,38,18,4,709,1,221,0,63,,,,664,,,,1908,19,66,74,24,2,0,25,1772,771,727,559,168,44
2010,7,34007608001,34,56023.0,34,1388,85,237,110,30,1278,8,545,2,449,,,,939,,,,3507,246,506,358,117,10,3,165,2460,1469,1388,711,677,81
2010,7,34007608202,34,82147.0,34,1417,32,262,51,15,1366,4,261,1,353,,,,1064,,,,4101,98,703,198,83,9,1,41,3166,1457,1417,1229,188,40
2010,7,34007608205,34,93015.0,34,1375,22,74,16,4,1359,0,201,0,116,,,,1259,,,,4117,62,215,90,24,0,0,40,3776,1404,1375,1338,37,29
2010,7,34007608206,34,74945.0,34,1296,15,57,30,9,1266,3,300,1,113,,,,1183,,,,3569,48,166,125,44,4,1,43,3263,1340,1296,1215,81,44
2010,7,34007608209,34,52083.0,34,1416,32,302,64,25,1352,1,479,1,416,,,,1000,,,,3544,113,652,181,87,3,6,70,2613,1493,1416,680,736,77
2010,7,34007608210,34,61250.0,34,1342,72,392,147,42,1195,5,489,1,626,,,,716,,,,3523,216,1017,485,163,10,1,201,1915,1570,1342,474,868,228
2010,7,34007608211,34,83887.0,34,2177,107,591,120,37,2057,7,755,1,839,,,,1338,,,,5615,424,1602,389,169,20,2,142,3256,2323,2177,1437,740,146
2010,7,34007608302,34,54341.0,34,2014,19,195,86,24,1928,3,901,0,313,,,,1701,,,,4786,61,456,312,100,6,0,97,4066,2108,2014,962,1052,94
2010,7,34007608303,34,62759.0,34,1129,24,131,50,15,1079,1,326,0,207,,,,922,,,,3077,79,261,184,84,2,0,43,2608,1200,1129,790,339,71
2010,7,34007608304,34,64955.0,34,2797,52,217,95,21,2702,5,1223,1,382,,,,2415,,,,6047,166,488,286,73,7,1,87,5225,2879,2797,2008,789,82
2010,7,34007608401,34,84712.0,34,1316,28,147,45,8,1271,3,202,1,227,,,,1089,,,,4149,98,490,204,68,7,2,59,3425,1353,1316,1263,53,37
2010,7,34007608402,34,103158.0,34,1257,25,203,33,15,1224,4,279,2,279,,,,978,,,,3683,106,659,139,77,7,2,50,2782,1303,1257,1190,67,46
2010,7,34007608403,34,97663.0,34,2153,145,579,107,34,2046,4,237,1,859,,,,1294,,,,7504,586,1982,466,255,24,1,137,4519,2222,2153,1913,240,69
2010,7,34007608404,34,73650.0,34,2400,67,541,81,39,2319,6,647,2,727,,,,1673,,,,6593,200,1533,345,189,28,2,95,4546,2497,2400,2079,321,97
2010,7,34007608503,34,53750.0,34,1183,22,485,86,31,1097,2,497,1,604,,,,579,,,,2780,61,1057,260,124,5,1,105,1427,1237,1183,568,615,54
2010,7,34007608504,34,38106.0,34,1330,28,428,73,36,1257,4,622,1,552,,,,778,,,,2897,88,940,210,127,10,1,75,1656,1495,1330,562,768,165
2010,7,34007608600,34,45667.0,34,2064,29,411,137,45,1927,13,837,0,613,,,,1451,,,,5000,105,956,515,152,28,0,195,3564,2235,2064,1269,795,171
2010,7,34007608700,34,69595.0,34,2806,58,116,53,25,2753,2,840,1,250,,,,2556,,,,7588,211,318,237,117,7,3,67,6865,2949,2806,2272,534,143
2010,7,34007608800,34,66630.0,34,1975,77,218,106,30,1869,2,612,0,424,,,,1551,,,,5357,275,620,444,114,10,0,203,4135,2069,1975,1482,493,94
2010,7,34007608901,34,72361.0,34,2046,20,116,88,21,1958,1,587,0,240,,,,1806,,,,5720,88,427,363,117,8,0,137,4943,2136,2046,1706,340,90
2010,7,34007608903,34,80156.0,34,1133,7,29,20,4,1113,1,182,0,61,,,,1072,,,,3443,26,74,86,49,1,2,20,3271,1161,1133,1099,34,28
2010,7,34007608904,34,83789.0,34,513,1,5,9,0,504,1,100,0,16,,,,497,,,,1486,10,13,18,18,2,1,9,1433,542,513,467,46,29
2010,7,34007609000,34,60750.0,34,582,2,268,43,9,539,3,206,0,319,,,,263,,,,1634,14,758,189,49,7,0,114,692,621,582,469,113,39
2010,7,34007609103,34,67917.0,34,1880,37,374,77,33,1803,7,530,0,513,,,,1367,,,,5439,123,1169,353,137,12,1,105,3892,1991,1880,1611,269,111
2010,7,34007609201,34,62243.0,34,1730,22,638,95,25,1635,3,516,1,769,,,,961,,,,4494,61,1644,368,142,9,5,121,2512,1811,1730,1282,448,81
2010,7,34007609202,34,58750.0,34,1684,43,1120,100,43,1584,10,471,2,1293,,,,391,,,,4773,136,3145,435,205,27,6,129,1125,1803,1684,1196,488,119
2010,7,34007609203,34,81622.0,34,3118,188,1146,168,53,2950,10,706,0,1527,,,,1591,,,,9101,625,3642,650,289,26,2,210,4307,3240,3118,2719,399,122
2010,7,34007609204,34,46600.0,34,1401,12,981,86,46,1315,5,410,0,1099,,,,302,,,,4033,47,3044,325,200,15,0,107,620,1538,1401,1015,386,137
2010,7,34007609205,34,82673.0,34,2247,43,402,175,38,2072,6,468,0,636,,,,1611,,,,6719,169,1250,728,150,19,0,357,4774,2382,2247,1857,390,135
2010,7,34007610300,34,15227.0,34,1026,29,521,201,29,825,4,786,1,754,,,,272,,,,2328,84,1086,490,91,5,3,222,837,1126,1026,172,854,100
2010,7,34007610400,34,20917.0,34,1150,9,646,452,37,698,16,356,0,1109,,,,41,,,,5573,57,2899,1991,209,50,2,1176,1180,1554,1150,492,658,404
2010,7,34007610500,34,52585.0,34,2117,159,771,630,50,1487,9,489,0,1558,,,,559,,,,6603,643,2352,2360,243,36,3,1331,1995,2193,2117,1693,424,76
2010,7,34007610600,34,39506.0,34,665,40,110,63,16,602,1,447,0,223,,,,442,,,,1254,90,268,182,30,6,1,84,775,765,665,148,517,100
2010,7,34007610800,34,57548.0,34,1165,20,342,253,38,912,24,392,1,645,,,,520,,,,3130,71,922,908,126,49,1,407,1554,1252,1165,847,318,87
2010,7,34007610900,34,57500.0,34,1536,7,18,26,10,1510,5,627,0,61,,,,1475,,,,3433,35,30,82,34,8,0,28,3298,1579,1536,938,598,43
2010,7,34007611000,34,50140.0,34,2320,42,65,91,22,2229,4,846,0,215,,,,2105,,,,6445,178,212,470,124,4,0,128,5799,2569,2320,1363,957,249
2010,7,34007611100,34,50096.0,34,1256,35,77,52,13,1204,1,472,1,172,,,,1084,,,,2964,111,161,197,44,3,2,88,2555,1343,1256,809,447,87
2010,7,34007611200,34,68650.0,34,1630,25,78,52,13,1578,5,435,1,171,,,,1459,,,,4403,86,205,191,59,9,2,79,3963,1712,1630,1303,327,82
2010,7,34007611300,34,67113.0,34,1478,30,71,52,12,1426,0,401,0,157,,,,1321,,,,4328,118,240,246,55,2,1,78,3834,1563,1478,1230,248,85
2010,7,34007611400,34,71958.0,34,1577,20,164,48,17,1529,5,363,1,252,,,,1325,,,,4568,68,466,222,120,12,3,68,3831,1647,1577,1448,129,70
2010,7,34007611500,34,74923.0,34,1675,14,59,68,15,1607,2,454,0,154,,,,1521,,,,4940,63,393,341,75,5,0,143,4261,1795,1675,1510,165,120
2010,7,34007611600,34,50833.0,34,2084,56,427,236,49,1848,11,1068,1,751,,,,1333,,,,4397,164,820,685,138,24,2,311,2938,2334,2084,643,1441,250
2010,7,34007611700,34,67625.0,34,1156,17,44,47,14,1109,1,396,0,117,,,,1039,,,,2992,68,92,173,44,4,2,72,2710,1222,1156,894,262,66
2010,15,34015500100,34,56667.0,34,1755,16,94,63,16,1692,4,660,0,189,,,,1566,,,,4288,64,210,258,67,7,2,99,3839,1912,1755,1137,618,157
2010,15,34015500201,34,67188.0,34,980,7,18,18,3,962,1,289,1,46,,,,934,,,,2537,32,52,103,22,1,1,39,2390,1017,980,875,105,37
2010,15,34015500202,34,65617.0,34,1838,24,155,43,14,1795,1,499,1,231,,,,1607,,,,4943,74,369,140,108,4,2,26,4360,1909,1838,1364,474,71
2010,15,34015500203,34,74160.0,34,1988,33,73,50,18,1938,3,746,0,170,,,,1818,,,,4727,74,177,153,56,7,0,26,4387,2061,1988,1509,479,73
2010,15,34015500204,34,76387.0,34,2559,71,289,83,24,2476,6,1045,0,463,,,,2096,,,,6070,211,549,252,90,7,0,79,5134,2782,2559,1385,1174,223
2010,15,34015500205,34,59679.0,34,1464,8,99,23,15,1441,5,496,0,147,,,,1317,,,,3400,24,267,83,74,6,0,17,3012,1672,1464,1254,210,208
2010,15,34015500300,34,62305.0,34,1092,4,8,19,12,1073,1,276,0,43,,,,1049,,,,3036,18,41,62,45,5,0,4,2923,1153,1092,908,184,61
2010,15,34015500400,34,41096.0,34,2286,14,799,134,52,2152,6,696,3,974,,,,1312,,,,6097,43,2239,542,325,21,4,143,3322,2533,2286,1347,939,247
2010,15,34015500500,34,66987.0,34,1946,8,70,24,17,1922,1,593,0,117,,,,1829,,,,4899,37,196,115,76,3,0,20,4567,2048,1946,1613,333,102
2010,15,34015500600,34,110586.0,34,3262,95,178,73,21,3189,9,615,2,366,,,,2896,,,,9555,345,560,289,125,13,5,56,8451,3405,3262,2996,266,143
2010,15,34015500701,34,64641.0,34,3187,33,124,64,22,3123,6,1048,0,243,,,,2944,,,,7988,92,275,257,116,11,0,60,7434,3288,3187,2827,360,101
2010,15,34015500702,34,81111.0,34,2031,18,32,28,6,2003,5,413,0,85,,,,1946,,,,5781,69,80,152,65,16,0,26,5525,2168,2031,1875,156,137
2010,15,34015500703,34,92850.0,34,501,2,5,5,2,496,1,90,1,16,,,,485,,,,1448,7,25,40,16,4,1,14,1381,524,501,465,36,23
2010,15,34015500800,34,105924.0,34,829,5,5,8,3,821,1,180,1,23,,,,806,,,,2278,24,21,31,31,3,1,5,2193,860,829,749,80,31
2010,15,34015500900,34,83011.0,34,1081,11,29,14,6,1067,2,249,0,61,,,,1020,,,,3055,50,104,74,44,5,1,11,2840,1125,1081,985,96,44
2010,15,34015501001,34,63333.0,34,806,12,118,58,19,748,0,272,0,201,,,,605,,,,2175,41,355,248,98,5,0,75,1601,869,806,596,210,63
2010,15,34015501002,34,37406.0,34,1810,10,593,164,40,1646,7,916,6,782,,,,1028,,,,4244,31,1562,577,178,14,22,197,2240,2014,1810,709,1101,204
2010,15,34015501003,34,72353.0,34,1472,13,242,69,26,1403,2,479,1,340,,,,1132,,,,3755,58,617,260,142,4,6,53,2875,1573,1472,1074,398,101
2010,15,34015501101,34,35127.0,34,1847,11,329,132,22,1715,5,864,0,486,,,,1361,,,,4052,41,782,456,132,11,0,238,2848,1958,1847,1144,703,111
2010,15,34015501102,34,77628.0,34,2754,180,352,125,31,2629,8,1000,2,681,,,,2073,,,,6697,622,772,363,145,18,5,123,5012,2857,2754,1951,803,103
2010,15,34015501103,34,76418.0,34,1858,104,95,74,17,1784,3,382,1,282,,,,1576,,,,5517,414,303,310,103,13,3,81,4600,1934,1858,1680,178,76
2010,15,34015501104,34,68171.0,34,1085,25,67,52,11,1033,3,261,1,154,,,,931,,,,3193,94,206,170,61,8,2,52,2770,1128,1085,938,147,43
2010,15,34015501105,34,56394.0,34,1184,29,153,66,12,1118,3,496,1,260,,,,924,,,,2739,84,373,192,76,9,1,48,2148,1365,1184,558,626,181
2010,15,34015501106,34,65764.0,34,1322,22,397,55,19,1267,0,333,0,484,,,,838,,,,3742,64,1147,200,94,2,0,55,2380,1386,1322,1139,183,64
2010,15,34015501107,34,77391.0,34,1639,15,42,32,19,1607,4,363,1,110,,,,1529,,,,4621,42,134,139,83,12,1,25,4324,1733,1639,1529,110,94
2010,15,34015501201,34,119071.0,34,1975,69,88,29,12,1946,0,209,0,196,,,,1779,,,,6254,257,261,121,62,4,0,25,5645,2010,1975,1906,69,35
2010,15,34015501202,34,108472.0,34,1524,49,51,16,8,1508,1,150,0,123,,,,1401,,,,4787,156,132,109,58,2,0,5,4434,1549,1524,1493,31,25
2010,15,34015501203,34,74375.0,34,1271,10,21,30,9,1241,3,341,0,70,,,,1201,,,,3369,39,57,96,32,4,0,18,3219,1304,1271,1179,92,33
2010,15,34015501204,34,82500.0,34,1310,22,46,33,7,1277,0,208,0,104,,,,1206,,,,3857,73,150,136,50,0,4,20,3560,1330,1310,1265,45,20
2010,15,34015501205,34,122216.0,34,988,38,64,29,11,959,1,239,0,141,,,,847,,,,2958,147,173,136,64,3,1,32,2538,1023,988,871,117,35
2010,15,34015501206,34,72549.0,34,1501,44,114,46,28,1455,4,490,1,228,,,,1273,,,,3940,128,243,195,108,8,4,37,3412,1578,1501,991,510,77
2010,15,34015501208,34,74613.0,34,1700,40,47,22,12,1678,0,591,0,119,,,,1581,,,,3984,148,106,76,32,1,0,19,3678,1776,1700,1479,221,76
2010,15,34015501209,34,61387.0,34,2775,109,378,118,32,2657,6,862,0,627,,,,2148,,,,7022,365,869,365,187,12,0,107,5482,2862,2775,1530,1245,87
2010,15,34015501210,34,80474.0,34,1170,43,56,21,13,1149,3,122,0,133,,,,1037,,,,3698,139,136,117,63,6,0,35,3319,1187,1170,1138,32,17
2010,15,34015501212,34,70227.0,34,1367,52,174,55,17,1312,1,306,0,294,,,,1073,,,,3927,161,517,240,116,5,0,78,3050,1429,1367,1164,203,62
2010,15,34015501213,34,101280.0,34,1706,74,72,40,12,1666,2,437,0,197,,,,1509,,,,4763,223,181,183,62,7,0,39,4251,1762,1706,1454,252,56
2010,15,34015501301,34,68857.0,34,1348,9,13,21,7,1327,0,384,0,50,,,,1298,,,,3503,23,44,85,41,0,3,11,3381,1409,1348,1076,272,61
2010,15,34015501302,34,58877.0,34,1136,4,13,24,13,1112,3,420,0,58,,,,1078,,,,2780,13,33,102,61,4,0,33,2636,1229,1136,754,382,93
2010,15,34015501303,34,88583.0,34,1005,7,7,11,4,994,4,358,0,33,,,,972,,,,2728,20,26,35,23,4,0,14,2641,1067,1005,722,283,62
2010,15,34015501402,34,31597.0,34,1098,10,412,96,33,1002,4,454,1,535,,,,563,,,,3564,48,1222,436,149,9,2,218,1916,1242,1098,523,575,144
2010,15,34015501403,34,74195.0,34,1391,28,282,73,27,1318,1,380,0,394,,,,997,,,,3742,81,815,300,134,1,4,137,2570,1488,1391,1053,338,97
2010,15,34015501404,34,21992.0,34,548,12,25,21,8,527,1,367,1,65,,,,483,,,,2895,65,228,155,52,3,3,51,2493,578,548,204,344,30
2010,15,34015501405,34,89130.0,34,1360,51,142,44,8,1316,1,343,0,244,,,,1116,,,,3870,204,411,149,55,2,0,47,3151,1392,1360,1239,121,32
2010,15,34015501406,34,58734.0,34,1761,50,305,106,39,1655,0,640,0,483,,,,1278,,,,4508,136,793,338,152,6,1,127,3293,1890,1761,1000,761,129
2010,15,34015501500,34,72583.0,34,2916,38,511,128,39,2788,9,811,1,704,,,,2212,,,,8179,147,1473,487,277,30,2,130,6120,3128,2916,2284,632,212
2010,15,34015501603,34,53409.0,34,2625,33,243,92,23,2533,4,853,1,383,,,,2242,,,,6545,119,597,353,126,5,2,135,5561,2740,2625,1986,639,115
2010,15,34015501604,34,71120.0,34,2586,46,413,100,43,2486,7,665,0,599,,,,1987,,,,7654,155,1189,403,215,19,0,125,5951,2727,2586,1908,678,141
2010,15,34015501605,34,58152.0,34,1757,17,232,47,15,1710,7,564,0,313,,,,1444,,,,4519,72,663,203,106,12,0,75,3591,1847,1757,1500,257,90
2010,15,34015501606,34,84178.0,34,2262,41,333,63,36,2199,5,425,0,470,,,,1792,,,,6911,165,1083,307,180,15,1,104,5363,2345,2262,2078,184,83
2010,15,34015501608,34,65733.0,34,1986,37,196,68,27,1918,4,640,1,325,,,,1661,,,,5126,132,564,265,138,12,1,66,4213,2065,1986,1691,295,79
2010,15,34015501609,34,113456.0,34,1599,54,265,59,15,1540,4,218,0,389,,,,1210,,,,5374,232,964,264,105,10,1,52,4010,1663,1599,1515,84,64
2010,15,34015501701,34,90278.0,34,1772,19,148,37,13,1735,4,320,0,215,,,,1557,,,,5381,85,500,181,88,9,1,42,4656,1836,1772,1669,103,64
2010,15,34015501702,34,88964.0,34,911,5,42,15,10,896,2,196,0,73,,,,838,,,,2616,24,122,95,40,6,0,27,2397,955,911,838,73,44
2010,15,34015501703,34,74135.0,34,1659,17,137,83,26,1576,5,397,0,257,,,,1402,,,,4650,70,386,306,99,9,0,78,4008,1724,1659,1416,243,65
2010,15,34015501704,34,63289.0,34,1507,7,65,41,20,1466,3,372,1,137,,,,1370,,,,4173,34,200,173,83,10,4,27,3815,1589,1507,1316,191,82
2010,15,34015501800,34,62120.0,34,579,1,12,28,3,551,2,126,0,45,,,,534,,,,1553,5,34,102,25,4,0,15,1470,626,579,475,104,47
2010,15,34015501900,34,66115.0,34,1475,10,217,38,19,1437,6,357,0,277,,,,1198,,,,4217,27,623,215,110,22,0,72,3363,1577,1475,1320,155,102
2010,15,34015502001,34,132803.0,34,1709,43,85,36,15,1673,1,231,0,176,,,,1533,,,,5641,208,215,164,84,5,0,24,5105,1763,1709,1477,232,54
2010,15,34015502002,34,108201.0,34,2233,47,75,42,18,2191,0,397,0,181,,,,2052,,,,6776,212,260,210,122,6,0,35,6141,2326,2233,2055,178,93
2010,15,34015502100,34,110395.0,34,1019,7,47,18,9,1001,0,157,0,81,,,,938,,,,3161,38,160,98,37,0,1,30,2895,1055,1019,969,50,36
2010,15,34015502200,34,113731.0,34,3141,155,309,79,34,3062,5,411,0,570,,,,2571,,,,10200,614,1017,365,200,13,0,80,8276,3275,3141,2834,307,134
2010,15,34015502300,34,74722.0,34,938,10,146,94,18,844,6,293,0,263,,,,675,,,,2584,35,388,441,95,15,2,245,1804,1004,938,611,327,66
2010,15,34015502400,34,89015.0,34,2087,41,271,61,18,2026,3,452,0,388,,,,1699,,,,6042,154,755,240,129,9,1,68,4926,2172,2087,1935,152,85
2010,45,42045400301,42,56929.0,42,2437,118,1544,118,79,2319,7,753,2,1835,,,,602,,,,6674,363,4447,477,295,15,10,211,1333,2655,2437,1049,1388,218
2010,45,42045400302,42,46531.0,42,1358,50,833,52,29,1306,3,332,1,951,,,,407,,,,4103,173,2698,232,157,12,1,83,979,1479,1358,774,584,121
2010,45,42045400401,42,38125.0,42,1784,349,874,106,58,1678,5,593,2,1381,,,,403,,,,5026,1243,2385,400,197,28,5,175,993,1988,1784,890,894,204
2010,45,42045400402,42,67313.0,42,1712,182,949,102,44,1610,3,635,1,1256,,,,456,,,,4608,639,2620,365,163,8,3,179,996,1859,1712,787,925,147
2010,45,42045400500,42,59222.0,42,1574,155,556,97,30,1477,0,587,0,827,,,,747,,,,4235,553,1522,372,144,2,0,182,1832,1681,1574,961,613,107
2010,45,42045400600,42,74570.0,42,2074,168,365,64,40,2010,2,796,2,632,,,,1442,,,,5316,601,1015,213,169,15,4,99,3413,2180,2074,1371,703,106
2010,45,42045400700,42,51136.0,42,1728,309,588,83,34,1645,2,425,1,1004,,,,724,,,,5384,1301,1910,342,170,12,3,183,1805,1822,1728,1230,498,94
2010,45,42045400801,42,42380.0,42,1067,96,765,25,21,1042,2,593,0,900,,,,167,,,,2010,219,1407,66,61,6,0,37,280,1362,1067,101,966,295
2010,45,42045400802,42,64351.0,42,1322,58,225,31,16,1291,2,451,2,331,,,,991,,,,3493,201,645,133,89,4,6,47,2501,1392,1322,959,363,70
2010,45,42045400900,42,74091.0,42,569,15,28,7,2,562,0,116,0,52,,,,517,,,,1584,50,100,31,15,1,0,8,1410,584,569,529,40,15
2010,45,42045401000,42,81978.0,42,725,18,50,11,4,714,1,234,0,84,,,,641,,,,1934,49,132,49,16,1,0,19,1717,773,725,501,224,48
2010,45,42045401101,42,79962.0,42,1214,13,66,19,8,1195,1,468,0,105,,,,1109,,,,2924,40,173,84,59,2,1,20,2629,1281,1214,916,298,67
2010,45,42045401103,42,60309.0,42,1202,27,64,19,5,1183,1,316,0,114,,,,1088,,,,3503,98,213,98,44,3,0,11,3134,1272,1202,938,264,70
2010,45,42045401104,42,51406.0,42,1629,27,84,28,13,1601,2,530,0,147,,,,1482,,,,4134,87,234,86,53,6,0,22,3732,1723,1629,1348,281,94
2010,45,42045401200,42,38795.0,42,1550,29,47,20,7,1530,2,618,0,102,,,,1448,,,,3636,106,131,53,31,4,0,6,3358,1637,1550,1072,478,87
2010,45,42045401301,42,48849.0,42,872,145,117,27,14,845,1,510,0,300,,,,572,,,,1621,408,215,64,38,2,0,16,942,1066,872,11,861,194
2010,45,42045401302,42,52289.0,42,1170,31,69,25,7,1145,1,378,1,133,,,,1037,,,,3032,103,203,78,29,3,1,14,2679,1245,1170,869,301,75
2010,45,42045401401,42,56827.0,42,847,31,77,21,13,826,1,293,0,141,,,,706,,,,2114,98,199,62,61,4,0,17,1735,883,847,679,168,36
2010,45,42045401402,42,60617.0,42,1708,42,204,35,21,1673,4,722,0,301,,,,1407,,,,3947,151,535,116,127,9,0,45,3080,1806,1708,957,751,98
2010,45,42045401501,42,54226.0,42,1409,10,24,8,13,1401,1,453,0,55,,,,1354,,,,3469,36,67,41,53,4,0,2,3307,1441,1409,1211,198,32
2010,45,42045401502,42,58728.0,42,1844,181,296,34,23,1810,5,744,1,533,,,,1311,,,,4307,471,646,79,97,15,1,16,3061,1967,1844,841,1003,123
2010,45,42045401600,42,65531.0,42,785,47,215,11,13,774,0,311,0,284,,,,501,,,,1824,117,462,43,55,1,0,9,1180,823,785,479,306,38
2010,45,42045401700,42,60536.0,42,923,61,470,35,19,888,1,287,1,572,,,,351,,,,2668,234,1490,116,84,3,6,36,815,1025,923,618,305,102
2010,45,42045401800,42,65721.0,42,1429,39,651,39,45,1390,5,489,0,771,,,,658,,,,3684,147,1897,146,176,10,1,30,1423,1591,1429,922,507,162
2010,45,42045401900,42,55466.0,42,1935,44,659,55,30,1880,1,772,0,774,,,,1161,,,,4480,145,1670,144,133,7,0,40,2485,2043,1935,1411,524,108
2010,45,42045402000,42,49254.0,42,1225,35,525,30,38,1195,1,661,0,615,,,,610,,,,2456,86,1166,63,96,3,0,8,1097,1341,1225,605,620,116
2010,45,42045402100,42,43203.0,42,2169,11,1871,26,40,2143,4,626,2,1943,,,,226,,,,5813,38,5122,105,122,6,7,54,464,2316,2169,1815,354,147
2010,45,42045402200,42,68375.0,42,842,7,695,9,26,833,2,336,0,733,,,,109,,,,2309,31,1927,44,62,9,0,7,273,945,842,521,321,103
2010,45,42045402300,42,83766.0,42,1513,7,1391,27,28,1486,6,697,0,1441,,,,72,,,,3321,19,3092,67,62,11,0,13,124,1624,1513,507,1006,111
2010,45,42045402400,42,87635.0,42,1092,9,905,26,22,1066,2,309,0,945,,,,147,,,,3459,23,3000,84,96,9,0,14,317,1321,1092,479,613,229
2010,45,42045402500,42,67500.0,42,1252,3,1035,19,35,1233,3,416,1,1090,,,,162,,,,3582,14,2971,74,147,5,3,36,406,1451,1252,598,654,199
2010,45,42045402600,42,95250.0,42,1023,10,700,19,22,1004,5,250,0,744,,,,279,,,,3646,37,2457,70,111,12,0,17,1012,1116,1023,686,337,93
2010,45,42045402700,42,118185.0,42,824,5,611,8,14,816,0,227,0,633,,,,191,,,,2546,19,2040,42,65,1,1,16,404,916,824,519,305,92
2010,45,42045402800,42,48973.0,42,2112,37,1185,49,44,2063,7,681,1,1303,,,,809,,,,5697,118,3450,183,212,16,1,41,1859,2265,2112,1479,633,153
2010,45,42045402900,42,88450.0,42,1352,0,1268,29,40,1323,2,444,1,1323,,,,29,,,,3471,4,3262,97,104,7,1,18,75,1449,1352,733,619,97
2010,45,42045403001,42,50625.0,42,1242,8,10,6,7,1236,1,431,0,32,,,,1210,,,,3006,20,22,32,38,2,0,5,2919,1279,1242,1136,106,37
2010,45,42045403002,42,79145.0,42,1137,9,117,19,14,1118,0,390,0,155,,,,982,,,,2787,31,324,60,63,1,1,18,2349,1198,1137,896,241,61
2010,45,42045403101,42,89357.0,42,1263,29,284,30,26,1233,2,413,0,362,,,,901,,,,3433,109,941,134,111,8,1,49,2214,1354,1263,859,404,91
2010,45,42045403103,42,82404.0,42,1050,19,304,15,17,1035,3,323,0,351,,,,699,,,,2855,76,963,67,120,12,0,6,1678,1117,1050,750,300,67
2010,45,42045403104,42,57100.0,42,877,14,398,24,28,853,3,272,0,458,,,,419,,,,2498,67,1288,73,104,6,0,14,1019,975,877,451,426,98
2010,45,42045403200,42,65625.0,42,1731,32,281,18,17,1713,3,611,0,346,,,,1385,,,,4152,108,769,87,85,6,0,16,3168,1824,1731,1323,408,93
2010,45,42045403300,42,59250.0,42,2683,60,308,33,22,2650,9,1018,0,420,,,,2263,,,,6652,220,758,144,158,16,0,24,5476,2849,2683,1643,1040,166
2010,45,42045403401,42,104152.0,42,1170,35,310,37,18,1133,4,384,1,397,,,,773,,,,3028,103,879,131,79,10,1,38,1918,1251,1170,776,394,81
2010,45,42045403402,42,67750.0,42,1291,26,268,36,11,1255,2,356,1,339,,,,952,,,,3578,87,836,171,77,10,2,52,2514,1349,1291,1059,232,58
2010,45,42045403501,42,54675.0,42,1763,38,182,33,38,1730,4,731,1,288,,,,1475,,,,4273,73,352,103,120,6,4,18,3700,1863,1763,1033,730,100
2010,45,42045403502,42,29673.0,42,1195,14,97,15,10,1180,3,443,0,134,,,,1061,,,,2880,52,253,53,49,4,0,4,2518,1242,1195,908,287,47
2010,45,42045403601,42,52708.0,42,1553,21,34,20,6,1533,1,568,0,81,,,,1472,,,,3964,90,75,55,41,3,0,24,3731,1632,1553,1009,544,79
2010,45,42045403602,42,77330.0,42,684,5,4,4,3,680,1,167,0,17,,,,667,,,,1926,27,14,26,10,1,0,9,1865,702,684,646,38,18
2010,45,42045403701,42,83639.0,42,686,12,14,6,7,680,1,241,0,38,,,,648,,,,1763,37,31,42,31,3,0,6,1655,767,686,469,217,81
2010,45,42045403702,42,74814.0,42,999,13,12,13,13,986,4,417,0,57,,,,942,,,,2328,46,40,50,48,4,1,11,2178,1071,999,673,326,72
2010,45,42045403800,42,127614.0,42,2519,38,62,38,22,2481,3,942,1,160,,,,2359,,,,6454,119,192,124,117,12,1,36,5977,2703,2519,1585,934,184
2010,45,42045403901,42,83838.0,42,1557,18,52,23,6,1534,0,747,0,99,,,,1458,,,,3391,55,100,69,39,3,0,16,3178,1671,1557,777,780,114
2010,45,42045403902,42,116630.0,42,1408,8,12,6,8,1402,0,374,1,35,,,,1373,,,,3611,26,42,27,38,1,1,7,3496,1491,1408,1211,197,83
2010,45,42045404003,42,71771.0,42,1036,69,143,19,17,1017,2,554,0,250,,,,786,,,,2147,169,270,48,47,3,0,21,1637,1101,1036,433,603,65
2010,45,42045404004,42,71628.0,42,2394,36,29,26,7,2368,1,611,1,101,,,,2293,,,,6514,143,97,116,52,6,2,32,6182,2490,2394,2074,320,96
2010,45,42045404101,42,88690.0,42,2593,33,236,34,15,2559,3,835,0,319,,,,2274,,,,6484,88,582,105,72,15,0,24,5703,2665,2593,1858,735,72
2010,45,42045404102,42,95789.0,42,1899,24,213,42,26,1857,0,646,0,296,,,,1603,,,,4833,72,552,141,125,2,0,39,4043,2139,1899,1308,591,240
2010,45,42045404103,42,96830.0,42,1338,23,23,6,12,1332,0,482,0,63,,,,1275,,,,3322,67,43,40,41,0,0,4,3167,1384,1338,1016,322,46
2010,45,42045404300,42,96284.0,42,926,7,84,23,15,903,2,316,0,126,,,,800,,,,2410,32,282,106,76,3,0,25,1992,1010,926,534,392,84
2010,45,42045404400,42,85250.0,42,654,9,340,27,18,627,1,289,0,389,,,,265,,,,1615,20,888,77,49,5,0,25,628,697,654,344,310,43
2010,45,42045404500,42,69097.0,42,1838,16,1236,167,35,1671,6,739,1,1418,,,,420,,,,4991,45,3593,518,132,15,5,202,999,2059,1838,622,1216,221
2010,45,42045404600,42,77768.0,42,875,1,638,45,27,830,5,261,0,700,,,,175,,,,2493,5,1918,175,97,13,1,61,398,976,875,426,449,101
2010,45,42045404700,42,59634.0,42,950,13,555,60,21,890,1,561,0,634,,,,316,,,,3655,56,1516,249,119,4,2,106,1852,1043,950,226,724,93
2010,45,42045404800,42,71591.0,42,690,2,492,104,18,586,5,187,0,595,,,,95,,,,2136,12,1542,386,86,16,0,163,317,842,690,275,415,152
2010,45,42045404900,42,65449.0,42,435,2,336,61,20,374,0,117,0,407,,,,28,,,,1439,7,1096,216,91,2,0,118,125,527,435,159,276,92
2010,45,42045405000,42,51985.0,42,752,5,653,51,17,701,2,301,0,715,,,,37,,,,2130,18,1791,182,57,12,0,74,178,887,752,322,430,135
2010,45,42045405100,42,54543.0,42,880,1,855,13,9,867,1,308,0,870,,,,10,,,,2165,4,2087,46,33,2,0,12,27,1006,880,433,447,126
2010,45,42045405200,42,95188.0,42,1308,1,1255,36,11,1272,3,547,0,1290,,,,18,,,,3030,3,2876,116,50,7,0,43,51,1415,1308,428,880,107
2010,45,42045405300,42,52583.0,42,900,6,716,97,22,803,6,292,1,818,,,,82,,,,2610,16,2012,388,105,11,7,146,313,1192,900,376,524,292
2010,45,42045405400,42,48542.0,42,889,4,698,62,30,827,4,298,1,782,,,,107,,,,2429,15,1911,236,111,14,5,79,294,1099,889,326,563,210
2010,45,42045406100,42,54128.0,42,876,15,103,23,17,853,4,290,0,157,,,,719,,,,2328,57,301,81,57,18,0,22,1873,912,876,687,189,36
2010,45,42045406201,42,86098.0,42,1248,21,43,17,8,1231,0,392,0,87,,,,1161,,,,3036,55,110,63,39,2,0,11,2819,1298,1248,1153,95,50
2010,45,42045406202,42,64714.0,42,2287,39,94,35,26,2252,0,1010,0,185,,,,2102,,,,4970,97,189,98,91,4,0,14,4575,2392,2287,1847,440,105
2010,45,42045406300,42,67923.0,42,1207,9,408,39,22,1168,8,427,0,471,,,,736,,,,3239,25,1338,189,122,11,2,78,1663,1291,1207,550,657,84
2010,45,42045406401,42,63542.0,42,939,8,707,27,24,912,2,226,0,760,,,,179,,,,2855,18,2282,113,95,4,0,31,425,1023,939,570,369,84
2010,45,42045406402,42,76360.0,42,472,0,335,11,5,461,2,200,0,349,,,,123,,,,1085,1,802,42,24,3,0,14,241,542,472,273,199,70
2010,45,42045406500,42,81658.0,42,625,4,90,22,2,603,2,159,0,117,,,,508,,,,1828,10,345,101,40,6,0,31,1396,667,625,454,171,42
2010,45,42045406600,42,51528.0,42,907,1,111,16,5,891,0,333,0,128,,,,779,,,,2397,2,326,71,86,2,1,8,1972,1018,907,443,464,111
2010,45,42045406700,42,90625.0,42,1247,9,89,33,15,1214,2,361,0,142,,,,1105,,,,3469,20,274,136,113,4,0,19,3039,1346,1247,845,402,99
2010,45,42045406801,42,95991.0,42,1685,46,217,28,15,1657,2,560,0,306,,,,1379,,,,4295,125,525,110,81,10,1,41,3512,1774,1685,1303,382,89
2010,45,42045406802,42,81950.0,42,1652,8,240,33,12,1619,5,507,0,297,,,,1355,,,,4332,33,618,99,74,11,0,17,3579,1770,1652,1284,368,118
2010,45,42045406803,42,99563.0,42,3347,87,277,62,30,3285,12,1206,0,460,,,,2887,,,,8111,296,645,198,144,23,0,31,6972,3569,3347,2208,1139,222
2010,45,42045406902,42,97702.0,42,2190,15,39,28,9,2162,3,562,1,93,,,,2097,,,,5866,48,99,114,45,7,1,21,5645,2255,2190,2016,174,65
2010,45,42045406903,42,167766.0,42,1849,10,15,16,11,1833,2,448,0,52,,,,1797,,,,5030,42,54,69,35,4,0,7,4888,1875,1849,1630,219,26
2010,45,42045406904,42,83182.0,42,1906,55,31,15,7,1891,1,707,0,106,,,,1800,,,,5696,173,317,83,66,7,0,14,5119,1961,1906,1711,195,55
2010,45,42045407000,42,85577.0,42,1157,27,16,7,5,1150,0,504,0,52,,,,1105,,,,2531,81,84,37,30,1,0,5,2330,1263,1157,809,348,106
2010,45,42045407101,42,122431.0,42,1513,47,37,21,8,1492,0,510,0,115,,,,1398,,,,3713,174,88,69,41,2,0,28,3380,1559,1513,1110,403,46
2010,45,42045407102,42,144848.0,42,1132,18,17,13,6,1119,1,241,0,56,,,,1076,,,,3169,59,46,52,29,1,0,11,3023,1157,1132,1094,38,25
2010,45,42045407201,42,115179.0,42,1792,37,30,20,4,1772,4,737,0,95,,,,1697,,,,5135,119,218,86,44,10,0,33,4711,1924,1792,1220,572,132
2010,45,42045407202,42,104219.0,42,1289,26,26,9,4,1280,2,514,0,65,,,,1224,,,,3790,85,180,44,25,4,5,15,3476,1372,1289,862,427,83
2010,45,42045407401,42,103878.0,42,1495,42,188,22,14,1473,1,350,1,264,,,,1231,,,,4057,170,575,90,82,1,4,19,3206,1548,1495,1193,302,53
2010,45,42045407404,42,88056.0,42,1097,32,27,11,3,1086,3,296,0,76,,,,1021,,,,2843,119,81,49,45,5,0,6,2587,1125,1097,1037,60,28
2010,45,42045407501,42,46875.0,42,1181,18,71,16,12,1165,1,633,0,119,,,,1062,,,,2340,49,151,50,45,1,0,4,2090,1262,1181,739,442,81
2010,45,42045407502,42,88077.0,42,1583,66,176,41,16,1542,0,1034,1,299,,,,1284,,,,2987,137,413,85,57,0,1,24,2355,1719,1583,407,1176,136
2010,45,42045407600,42,91563.0,42,2076,99,90,38,23,2038,4,703,0,250,,,,1826,,,,6390,480,309,307,236,17,4,44,5300,2203,2076,1502,574,127
2010,45,42045407700,42,80625.0,42,1130,39,265,16,17,1114,3,459,0,335,,,,795,,,,2669,161,677,58,71,7,0,16,1737,1215,1130,613,517,85
2010,45,42045407801,42,147868.0,42,1696,38,23,8,3,1688,1,494,0,71,,,,1625,,,,4485,157,60,42,23,2,1,13,4229,1727,1696,1482,214,31
2010,45,42045407802,42,90208.0,42,2214,90,30,20,9,2194,3,408,0,151,,,,2063,,,,6353,317,109,58,35,5,1,13,5873,2262,2214,2029,185,48
2010,45,42045407803,42,102639.0,42,1928,43,20,17,10,1911,0,420,0,89,,,,1839,,,,5365,153,82,48,50,2,0,6,5072,1973,1928,1766,162,45
2010,45,42045407804,42,113750.0,42,1571,28,11,13,6,1558,2,309,0,60,,,,1511,,,,4506,98,35,53,32,6,0,10,4325,1607,1571,1490,81,36
2010,45,42045407805,42,126757.0,42,569,17,11,2,6,567,0,94,0,36,,,,533,,,,1696,69,41,14,25,0,0,0,1561,585,569,527,42,16
2010,45,42045407806,42,111738.0,42,618,37,23,9,7,609,4,166,0,78,,,,540,,,,1610,113,86,39,28,4,0,4,1375,643,618,552,66,25
2010,45,42045407901,42,71629.0,42,1407,39,14,13,10,1394,0,227,0,75,,,,1332,,,,3944,123,52,51,48,1,3,10,3707,1450,1407,1373,34,43
2010,45,42045407902,42,105135.0,42,1234,45,49,19,13,1215,1,513,0,128,,,,1106,,,,2760,115,113,46,45,1,0,16,2470,1293,1234,792,442,59
2010,45,42045407903,42,104464.0,42,1496,82,103,17,15,1479,1,606,1,216,,,,1280,,,,3438,198,232,59,63,3,1,13,2928,1620,1496,901,595,124
2010,45,42045408001,42,112568.0,42,2264,113,15,16,9,2248,1,517,0,155,,,,2109,,,,6170,418,41,75,71,5,0,11,5624,2329,2264,2064,200,65
2010,45,42045408002,42,130781.0,42,1609,90,23,14,13,1595,2,515,0,138,,,,1471,,,,4094,284,79,46,42,3,0,5,3681,1708,1609,1362,247,99
2010,45,42045408101,42,98864.0,42,1762,79,29,16,6,1746,3,400,0,132,,,,1630,,,,5320,289,182,75,30,5,1,18,4795,1801,1762,1574,188,39
2010,45,42045408102,42,95665.0,42,1323,83,12,17,6,1306,0,353,0,118,,,,1205,,,,3413,286,38,41,17,0,0,16,3056,1365,1323,1149,174,42
2010,45,42045408103,42,150372.0,42,1684,113,53,16,12,1668,1,498,0,193,,,,1491,,,,4431,373,157,66,55,2,0,11,3833,1737,1684,1166,518,53
2010,45,42045408300,42,104779.0,42,1399,36,92,28,15,1371,0,520,0,169,,,,1230,,,,4815,198,315,215,142,4,0,72,4084,1464,1399,1068,331,65
2010,45,42045408400,42,115541.0,42,865,20,12,3,2,862,0,431,0,38,,,,827,,,,1850,73,33,13,20,0,0,2,1722,943,865,517,348,78
2010,45,42045408500,42,175078.0,42,1529,116,33,21,9,1508,4,407,0,185,,,,1344,,,,3997,370,76,70,44,8,0,23,3476,1577,1529,1243,286,48
2010,45,42045408600,42,81103.0,42,1329,34,20,14,5,1315,1,341,0,75,,,,1254,,,,3543,107,55,51,43,1,0,5,3332,1351,1329,1134,195,22
2010,45,42045408700,42,163995.0,42,1780,41,37,21,8,1759,2,451,0,107,,,,1673,,,,4871,122,109,74,50,6,0,17,4567,1821,1780,1516,264,41
2010,45,42045408800,42,117454.0,42,2002,54,95,30,13,1972,0,731,0,195,,,,1807,,,,4780,175,243,108,75,3,0,30,4254,2089,2002,1696,306,87
2010,45,42045408900,42,156071.0,42,1047,36,20,9,8,1038,0,219,0,72,,,,975,,,,2933,111,63,47,32,1,1,9,2716,1075,1047,1004,43,28
2010,45,42045409000,42,137157.0,42,1346,55,30,15,9,1331,1,330,0,109,,,,1237,,,,3721,209,99,70,43,2,0,11,3357,1374,1346,1137,209,28
2010,45,42045409100,42,185577.0,42,1466,27,11,16,10,1450,1,348,0,64,,,,1402,,,,4180,102,42,67,46,5,0,12,3973,1505,1466,1291,175,39
2010,45,42045409200,42,141484.0,42,1473,29,21,20,7,1453,2,345,0,77,,,,1396,,,,4048,113,66,75,44,5,0,12,3808,1511,1473,1362,111,38
2010,45,42045409300,42,78788.0,42,888,33,14,17,7,871,2,252,0,76,,,,812,,,,2354,99,37,54,31,4,0,11,2172,909,888,759,129,21
2010,45,42045409400,42,129034.0,42,994,46,17,8,2,986,1,233,0,74,,,,920,,,,2861,179,78,31,20,2,1,8,2573,1018,994,878,116,24
2010,45,42045409500,42,77171.0,42,1666,52,27,15,16,1651,2,427,0,107,,,,1559,,,,4538,190,77,62,51,2,0,7,4211,1713,1666,1554,112,47
2010,45,42045409601,42,51447.0,42,1812,193,54,18,12,1794,0,661,0,277,,,,1535,,,,4585,665,163,62,83,1,1,15,3657,2034,1812,1166,646,222
2010,45,42045409602,42,55375.0,42,1650,128,88,52,17,1598,0,1041,0,282,,,,1368,,,,4641,403,249,193,84,3,0,37,3865,1772,1650,650,1000,122
2010,45,42045409701,42,88938.0,42,1953,154,34,22,8,1931,2,298,0,222,,,,1731,,,,7312,566,201,185,117,3,0,48,6377,2050,1953,1785,168,97
2010,45,42045409702,42,49236.0,42,169,4,5,1,3,168,0,51,0,13,,,,156,,,,1918,83,56,90,42,2,0,13,1722,175,169,153,16,6
2010,45,42045409802,42,40469.0,42,1539,94,22,35,16,1504,0,564,0,164,,,,1375,,,,6168,351,298,206,107,7,1,42,5362,1714,1539,958,581,175
2010,45,42045409803,42,67005.0,42,2840,143,102,69,23,2771,0,1133,3,338,,,,2502,,,,6907,425,273,201,84,4,5,49,6067,3069,2840,1777,1063,229
2010,45,42045409902,42,71151.0,42,2076,70,14,12,11,2064,2,806,0,108,,,,1968,,,,4820,207,54,48,33,4,0,13,4509,2293,2076,1399,677,217
2010,45,42045409903,42,69583.0,42,1548,28,10,9,7,1539,4,517,0,58,,,,1490,,,,3823,87,35,46,33,9,0,6,3653,1655,1548,1291,257,107
2010,45,42045409904,42,60350.0,42,1247,37,5,13,1,1234,1,290,0,57,,,,1190,,,,3573,112,22,50,31,3,1,9,3395,1317,1247,1159,88,70
2010,45,42045410000,42,78182.0,42,1655,45,17,14,6,1641,0,586,0,83,,,,1572,,,,3987,151,45,36,42,2,0,10,3737,1808,1655,1222,433,153
2010,45,42045410100,42,45385.0,42,2114,90,76,16,7,2098,4,315,0,193,,,,1921,,,,8028,327,1651,190,129,19,1,89,5812,2197,2114,1925,189,83
2010,45,42045410200,42,74773.0,42,1436,73,21,26,8,1410,0,414,0,125,,,,1311,,,,3640,276,50,106,41,1,0,19,3253,1513,1436,1268,168,77
2010,45,42045410301,42,74375.0,42,2313,89,41,22,14,2291,1,476,0,164,,,,2149,,,,8284,335,1006,165,88,2,2,64,6787,2416,2313,2083,230,103
2010,45,42045410302,42,61019.0,42,3880,174,71,54,27,3826,3,1549,0,327,,,,3553,,,,8947,548,184,180,116,10,0,44,8045,4295,3880,2225,1655,415
2010,45,42045410400,42,97179.0,42,2998,144,61,29,18,2969,4,511,1,254,,,,2744,,,,8791,539,158,190,104,16,3,35,7936,3101,2998,2903,95,103
2010,45,42045410500,42,78049.0,42,1540,717,346,94,58,1446,3,361,2,1206,,,,334,,,,5076,2764,1005,370,201,15,11,182,898,1630,1540,808,732,90
2010,45,42045410601,42,83105.0,42,1290,15,19,20,8,1270,1,373,0,65,,,,1225,,,,3372,56,43,63,46,1,1,18,3207,1344,1290,1052,238,54
2010,45,42045410602,42,62528.0,42,1780,27,90,17,15,1763,0,449,0,146,,,,1634,,,,4880,106,203,84,63,3,0,20,4485,1836,1780,1560,220,56
2010,45,42045410700,42,70938.0,42,1491,2,1336,58,32,1433,6,546,0,1409,,,,82,,,,5279,16,4163,465,106,20,0,296,678,2002,1491,554,937,511
2010,45,42045410800,42,,42,2892,130,93,40,23,2852,2,751,0,285,,,,2607,,,,7719,443,316,151,143,8,2,15,6792,2999,2892,2598,294,107
2010,45,42045980000,42,29711.0,42,0,0,0,0,0,0,0,0,0,0,,,,0,,,,0,0,0,0,0,0,0,0,0,0,0,0,0,0
2010,91,42091200103,42,41711.0,42,1295,83,5,18,7,1277,1,155,1,113,,,,1182,,,,4140,329,34,105,49,3,3,25,3697,1325,1295,1263,32,30
2010,91,42091200104,42,28020.0,42,1474,74,4,14,4,1460,1,223,0,97,,,,1377,,,,4207,257,16,57,32,4,1,11,3886,1506,1474,1430,44,32
2010,91,42091200105,42,33136.0,42,914,104,8,9,8,905,0,134,0,129,,,,785,,,,2778,435,23,42,44,3,0,22,2251,947,914,811,103,33
2010,91,42091200106,42,42294.0,42,865,45,16,6,7,859,3,374,1,77,,,,788,,,,1857,135,55,30,27,8,3,7,1622,997,865,445,420,132
2010,91,42091200200,42,63125.0,42,428,10,4,3,4,425,0,112,0,21,,,,407,,,,1375,35,37,17,25,0,1,5,1272,453,428,296,132,25
2010,91,42091200301,42,62250.0,42,2525,199,200,95,40,2430,5,1080,2,536,,,,1989,,,,5739,539,388,322,154,13,7,147,4491,2878,2525,1136,1389,353
2010,91,42091200305,42,44438.0,42,893,4,6,11,2,882,0,293,0,23,,,,870,,,,2291,14,17,56,18,5,0,18,2219,907,893,701,192,14
2010,91,42091200306,42,55114.0,42,1378,11,23,29,8,1349,0,397,2,72,,,,1306,,,,3434,40,68,108,41,0,4,55,3226,1421,1378,1015,363,43
2010,91,42091200307,42,120722.0,42,1381,32,132,28,21,1353,6,639,0,214,,,,1167,,,,3063,98,332,120,79,15,0,31,2508,1492,1381,627,754,111
2010,91,42091200308,42,78295.0,42,1658,84,138,45,17,1613,3,664,2,282,,,,1376,,,,3983,261,325,148,83,15,2,32,3265,1734,1658,930,728,76
2010,91,42091200309,42,50750.0,42,960,12,18,14,4,946,1,210,0,46,,,,914,,,,2660,55,51,57,44,2,1,9,2498,973,960,885,75,13
2010,91,42091200310,42,95125.0,42,1139,14,23,16,5,1123,0,361,0,58,,,,1081,,,,2845,44,50,54,31,0,0,26,2694,1167,1139,906,233,28
2010,91,42091200401,42,64145.0,42,1418,15,23,29,9,1389,1,589,0,75,,,,1343,,,,3259,45,65,103,24,8,0,39,3078,1615,1418,842,576,197
2010,91,42091200402,42,64833.0,42,1625,19,50,61,16,1564,4,521,2,144,,,,1481,,,,4101,71,132,213,97,13,2,66,3720,1704,1625,1119,506,79
2010,91,42091200501,42,48171.0,42,1345,35,15,15,5,1330,1,256,1,72,,,,1273,,,,4081,127,68,76,48,4,7,27,3800,1360,1345,1264,81,15
2010,91,42091200502,42,67500.0,42,2236,85,172,101,36,2135,8,855,0,396,,,,1840,,,,5420,286,393,331,141,18,0,123,4459,2461,2236,1063,1173,225
2010,91,42091200505,42,61678.0,42,2280,222,108,40,16,2240,1,563,0,389,,,,1891,,,,6905,716,268,143,75,5,1,35,5805,2455,2280,1688,592,175
2010,91,42091200506,42,65924.0,42,1464,84,47,14,3,1450,1,242,0,148,,,,1316,,,,4376,301,141,73,31,3,0,22,3878,1482,1464,1326,138,18
2010,91,42091200507,42,59918.0,42,2244,153,102,36,9,2208,3,819,1,304,,,,1940,,,,5365,464,258,130,51,4,1,31,4556,2295,2244,1862,382,51
2010,91,42091200602,42,54320.0,42,3010,539,170,52,32,2958,4,933,0,793,,,,2217,,,,7741,1728,421,201,127,6,0,41,5418,3085,3010,2607,403,75
2010,91,42091200603,42,69681.0,42,1234,99,57,16,7,1218,1,285,0,179,,,,1055,,,,3412,326,187,59,47,2,0,19,2831,1259,1234,1156,78,25
2010,91,42091200605,42,54524.0,42,2163,232,91,26,16,2137,1,660,0,366,,,,1797,,,,5706,889,256,106,80,4,0,17,4460,2290,2163,1996,167,127
2010,91,42091200606,42,59421.0,42,1215,115,46,29,11,1186,2,353,0,200,,,,1015,,,,3264,439,116,99,50,4,0,19,2636,1233,1215,1058,157,18
2010,91,42091200607,42,68448.0,42,1585,208,67,23,12,1562,0,291,0,309,,,,1276,,,,4667,725,164,86,86,2,0,13,3677,1600,1585,1541,44,15
2010,91,42091200703,42,60139.0,42,1581,214,40,35,12,1546,4,346,0,297,,,,1284,,,,4338,748,108,132,63,15,2,27,3375,1640,1581,1226,355,59
2010,91,42091200704,42,54050.0,42,1383,81,64,29,18,1354,2,456,2,196,,,,1187,,,,3455,280,159,81,78,5,11,22,2900,1499,1383,854,529,116
2010,91,42091200707,42,47308.0,42,1645,241,139,80,30,1565,6,634,0,483,,,,1162,,,,4037,815,345,275,118,15,0,121,2623,1858,1645,742,903,213
2010,91,42091200708,42,37202.0,42,1923,250,58,43,15,1880,1,445,1,361,,,,1562,,,,5419,966,167,160,109,7,1,35,4134,2086,1923,1598,325,163
2010,91,42091200800,42,36920.0,42,1267,211,49,60,31,1207,1,443,0,342,,,,925,,,,3290,773,136,224,97,4,1,89,2190,1333,1267,664,603,66
2010,91,42091200901,42,27534.0,42,1553,179,72,45,19,1508,2,618,0,312,,,,1241,,,,4143,780,226,190,128,15,5,88,2901,1648,1553,900,653,95
2010,91,42091200902,42,40469.0,42,533,37,41,28,3,505,0,236,1,106,,,,427,,,,1257,133,104,103,21,0,4,37,958,571,533,272,261,38
2010,91,42091200903,42,41019.0,42,1842,193,132,68,32,1774,3,841,1,423,,,,1419,,,,4152,626,301,224,135,9,3,96,2982,2033,1842,822,1020,191
2010,91,42091200906,42,54121.0,42,817,118,38,20,7,797,0,328,0,179,,,,638,,,,1998,323,94,71,42,0,0,21,1518,895,817,446,371,78
2010,91,42091200907,42,35929.0,42,1062,21,36,26,10,1036,2,369,0,89,,,,973,,,,2627,75,106,79,35,3,0,16,2392,1117,1062,783,279,55
2010,91,42091200908,42,54966.0,42,848,55,42,34,13,814,2,350,2,146,,,,702,,,,2092,221,122,139,75,12,10,55,1597,893,848,496,352,45
2010,91,42091201003,42,49583.0,42,2123,274,108,38,21,2085,0,762,3,439,,,,1684,,,,4918,712,242,135,82,3,6,43,3830,2229,2123,1450,673,106
2010,91,42091201004,42,55341.0,42,2027,240,94,35,21,1992,2,738,0,393,,,,1634,,,,4956,874,234,131,85,3,0,43,3717,2114,2027,1360,667,87
2010,91,42091201005,42,50089.0,42,1195,72,36,12,10,1183,0,172,0,130,,,,1065,,,,3454,230,112,64,47,0,0,22,3043,1214,1195,1130,65,19
2010,91,42091201006,42,37576.0,42,892,35,31,2,2,890,0,163,0,70,,,,822,,,,2224,97,71,14,26,0,0,5,2025,930,892,852,40,38
2010,91,42091201100,42,66691.0,42,1290,18,58,33,19,1257,1,444,1,128,,,,1162,,,,3229,81,166,124,113,4,1,33,2831,1348,1290,908,382,58
2010,91,42091201201,42,45638.0,42,2381,213,72,26,10,2355,1,725,0,322,,,,2059,,,,5867,627,199,89,75,2,1,20,4943,2483,2381,1712,669,102
2010,91,42091201203,42,49067.0,42,1365,37,27,9,4,1356,0,530,0,77,,,,1288,,,,3389,133,79,65,46,1,1,5,3124,1415,1365,912,453,50
2010,91,42091201204,42,57845.0,42,946,20,196,9,7,937,1,360,0,233,,,,713,,,,2149,51,507,66,52,3,0,20,1516,1008,946,813,133,62
2010,91,42091201301,42,52847.0,42,1396,55,121,46,21,1350,1,605,3,240,,,,1156,,,,3357,164,341,170,66,1,10,58,2717,1457,1396,750,646,61
2010,91,42091201302,42,51171.0,42,1208,27,184,74,21,1134,1,475,1,302,,,,906,,,,3060,77,482,334,151,12,7,139,2192,1310,1208,652,556,102
2010,91,42091201404,42,60132.0,42,1931,161,77,15,7,1916,1,614,1,262,,,,1669,,,,4953,523,213,54,41,2,1,19,4154,2013,1931,1358,573,82
2010,91,42091201406,42,64559.0,42,1537,93,102,21,9,1516,0,216,0,219,,,,1318,,,,4482,351,333,101,55,0,0,17,3726,1560,1537,1493,44,23
2010,91,42091201407,42,47740.0,42,904,23,239,11,12,893,3,176,0,285,,,,619,,,,2594,95,678,53,56,9,0,21,1735,930,904,806,98,26
2010,91,42091201408,42,58406.0,42,1483,155,36,14,2,1469,0,225,0,210,,,,1273,,,,4345,511,88,54,38,3,0,14,3691,1499,1483,1414,69,16
2010,91,42091201409,42,65259.0,42,1480,108,35,17,6,1463,1,244,0,166,,,,1314,,,,4120,364,92,79,58,2,1,17,3586,1508,1480,1415,65,28
2010,91,42091201410,42,53132.0,42,1015,57,36,17,7,998,0,355,0,116,,,,899,,,,2519,187,176,64,42,2,1,19,2092,1053,1015,843,172,38
2010,91,42091201411,42,67212.0,42,1047,44,45,17,10,1030,3,353,0,115,,,,932,,,,2556,140,115,58,50,4,0,13,2234,1086,1047,827,220,39
2010,91,42091201501,42,58417.0,42,1487,97,32,27,7,1460,0,643,1,163,,,,1324,,,,3462,311,70,86,31,0,1,14,3035,1598,1487,769,718,111
2010,91,42091201502,42,66604.0,42,693,22,10,13,8,680,1,125,0,51,,,,642,,,,1908,87,34,66,37,2,0,23,1725,713,693,679,14,20
2010,91,42091201603,42,52917.0,42,1711,40,652,44,31,1667,2,466,1,762,,,,949,,,,4552,130,1793,182,165,10,1,44,2409,1772,1711,1486,225,61
2010,91,42091201604,42,55625.0,42,1124,30,328,43,20,1081,1,266,0,413,,,,711,,,,3128,97,961,171,94,5,1,42,1928,1151,1124,1042,82,27
2010,91,42091201605,42,60455.0,42,1044,32,119,24,11,1020,0,256,0,180,,,,864,,,,2980,119,397,125,63,2,0,37,2362,1070,1044,985,59,26
2010,91,42091201606,42,44375.0,42,844,18,265,25,18,819,1,286,0,325,,,,519,,,,2200,70,723,94,87,1,0,37,1282,885,844,549,295,41
2010,91,42091201607,42,25313.0,42,1323,29,135,35,26,1288,0,378,0,220,,,,1103,,,,3468,87,361,140,97,1,0,29,2893,1362,1323,1110,213,39
2010,91,42091201608,42,32522.0,42,1798,72,80,32,10,1766,1,502,0,191,,,,1607,,,,4684,231,206,121,59,5,0,15,4168,1886,1798,1439,359,88
2010,91,42091201703,42,35563.0,42,1145,12,38,17,6,1128,0,289,0,74,,,,1071,,,,3114,43,123,80,53,2,1,21,2871,1173,1145,1047,98,28
2010,91,42091201704,42,28071.0,42,1227,19,185,21,13,1206,2,374,0,234,,,,993,,,,3333,49,530,84,85,4,0,27,2638,1277,1227,985,242,50
2010,91,42091201705,42,29116.0,42,1658,41,83,33,11,1625,6,496,0,169,,,,1489,,,,4403,104,179,128,67,10,0,52,3991,1716,1658,1231,427,58
2010,91,42091201706,42,35461.0,42,1734,95,189,49,18,1685,3,489,0,346,,,,1388,,,,4606,316,503,188,103,8,0,53,3623,1779,1734,1268,466,45
2010,91,42091201800,42,29679.0,42,1320,38,55,13,9,1307,1,613,0,111,,,,1209,,,,2779,114,136,54,52,1,0,6,2470,1450,1320,815,505,130
2010,91,42091201901,42,30815.0,42,1795,69,20,28,13,1767,1,422,0,128,,,,1667,,,,4725,249,58,105,65,2,0,22,4329,1854,1795,1671,124,59
2010,91,42091201902,42,27122.0,42,2479,252,322,40,22,2439,2,996,2,635,,,,1844,,,,5968,679,776,147,92,4,4,54,4359,2683,2479,1642,837,204
2010,91,42091202000,42,35550.0,42,1051,13,4,15,12,1036,1,413,0,45,,,,1006,,,,2543,31,10,52,52,1,0,13,2436,1097,1051,690,361,46
2010,91,42091202100,42,20273.0,42,2014,28,125,40,25,1974,0,931,0,215,,,,1799,,,,4422,87,254,134,79,0,0,14,3988,2128,2014,1341,673,114
2010,91,42091202201,42,48750.0,42,1798,98,244,59,27,1739,1,495,0,423,,,,1375,,,,4810,357,715,219,109,2,0,50,3577,1885,1798,1448,350,87
2010,91,42091202202,42,58780.0,42,960,150,370,49,13,911,0,146,1,576,,,,384,,,,3006,647,1205,195,66,1,3,56,1028,989,960,941,19,29
2010,91,42091202301,42,63438.0,42,1935,102,203,42,19,1893,1,625,0,361,,,,1574,,,,4571,301,512,107,100,4,0,24,3630,2068,1935,1444,491,133
2010,91,42091202302,42,38938.0,42,923,34,183,22,9,901,2,325,1,250,,,,673,,,,2100,93,490,66,45,8,3,19,1442,985,923,817,106,62
2010,91,42091202401,42,59896.0,42,1755,129,1424,55,48,1700,12,864,1,1642,,,,113,,,,3554,288,2901,144,119,31,1,35,179,1866,1755,10,1745,111
2010,91,42091202402,42,44107.0,42,1715,141,626,58,36,1657,3,410,0,851,,,,864,,,,4689,439,1808,216,146,14,0,101,2181,1823,1715,1351,364,108
2010,91,42091202500,42,40435.0,42,2159,148,1118,68,48,2091,5,1058,0,1365,,,,794,,,,5236,362,2665,217,157,12,1,56,1983,2351,2159,988,1171,192
2010,91,42091202602,42,41016.0,42,1008,39,87,13,9,995,1,452,0,148,,,,860,,,,2624,101,361,74,53,4,2,15,2088,1131,1008,579,429,123
2010,91,42091202603,42,50931.0,42,1312,34,113,23,17,1289,1,592,0,189,,,,1123,,,,3861,134,354,106,72,9,1,23,3268,1374,1312,786,526,62
2010,91,42091202604,42,71343.0,42,903,25,139,21,8,882,2,239,0,190,,,,713,,,,2342,103,415,84,50,4,4,26,1740,937,903,742,161,34
2010,91,42091203000,42,54034.0,42,1072,76,56,13,7,1059,0,264,1,153,,,,919,,,,3154,223,209,73,47,0,2,15,2658,1204,1072,852,220,132
2010,91,42091203103,42,67077.0,42,1019,30,20,12,4,1007,1,170,0,65,,,,954,,,,2985,116,62,47,27,3,0,9,2768,1063,1019,952,67,44
2010,91,42091203104,42,80009.0,42,1692,29,29,11,10,1681,2,549,0,81,,,,1611,,,,4182,85,88,40,51,4,1,3,3950,1751,1692,1261,431,59
2010,91,42091203105,42,85167.0,42,2193,94,84,29,15,2164,1,710,0,221,,,,1972,,,,5385,253,181,91,63,6,0,15,4867,2280,2193,1808,385,87
2010,91,42091203106,42,79356.0,42,768,25,27,16,6,752,1,373,0,76,,,,692,,,,1643,57,64,50,20,2,0,16,1484,807,768,378,390,39
2010,91,42091203203,42,75426.0,42,1539,178,117,40,21,1499,1,381,1,354,,,,1185,,,,4093,547,300,166,84,1,2,60,3099,1612,1539,974,565,73
2010,91,42091203204,42,105994.0,42,2710,291,102,45,16,2665,2,877,1,454,,,,2256,,,,6558,931,247,150,80,3,2,22,5273,2905,2710,1964,746,195
2010,91,42091203205,42,99188.0,42,790,32,91,13,5,777,0,154,0,140,,,,650,,,,2211,119,263,76,30,1,0,21,1777,823,790,703,87,33
2010,91,42091203207,42,84453.0,42,1164,59,36,17,3,1147,2,225,0,118,,,,1046,,,,3255,214,93,58,30,3,1,15,2899,1202,1164,1004,160,38
2010,91,42091203208,42,64267.0,42,1259,78,35,14,6,1245,1,481,1,135,,,,1124,,,,2758,238,79,38,21,2,1,15,2402,1395,1259,1123,136,136
2010,91,42091203302,42,116212.0,42,2232,77,140,39,14,2193,1,541,1,268,,,,1964,,,,5907,251,384,143,69,3,1,42,5157,2298,2232,2087,145,66
2010,91,42091203303,42,102841.0,42,1848,111,163,40,17,1808,2,799,1,328,,,,1520,,,,4155,308,462,166,65,10,1,54,3255,1939,1848,1281,567,91
2010,91,42091203304,42,75605.0,42,1629,121,165,36,21,1593,1,700,0,346,,,,1283,,,,3528,296,371,121,76,5,1,44,2735,1783,1629,903,726,154
2010,91,42091203401,42,50944.0,42,2894,77,318,65,24,2829,2,1306,1,482,,,,2412,,,,6153,206,684,226,108,3,1,68,5083,3006,2894,2064,830,112
2010,91,42091203402,42,107056.0,42,2836,212,214,57,33,2779,6,1231,2,520,,,,2316,,,,6189,528,461,178,96,8,2,59,5035,3114,2836,1820,1016,278
2010,91,42091203403,42,57768.0,42,1652,33,79,29,18,1623,0,854,2,155,,,,1497,,,,3192,82,195,79,65,0,8,18,2824,1725,1652,1269,383,73
2010,91,42091203500,42,84052.0,42,2475,55,903,222,53,2253,6,1004,1,1210,,,,1265,,,,6077,118,2191,971,220,17,6,535,2990,2656,2475,1325,1150,181
2010,91,42091203601,42,104393.0,42,989,14,548,234,37,755,8,289,0,800,,,,189,,,,3243,54,1641,1080,191,28,0,491,838,1111,989,384,605,122
2010,91,42091203602,42,97760.0,42,1363,15,433,119,44,1244,3,437,1,596,,,,767,,,,3763,47,1265,520,213,11,3,223,2001,1446,1363,977,386,83
2010,91,42091203700,42,102520.0,42,425,18,138,64,10,361,0,172,0,221,,,,204,,,,1545,47,535,259,38,3,0,123,799,474,425,199,226,49
2010,91,42091203801,42,81477.0,42,1277,28,332,190,39,1087,2,412,0,573,,,,704,,,,3709,99,1025,903,214,5,0,609,1757,1385,1277,698,579,108
2010,91,42091203803,42,74107.0,42,1879,36,595,462,64,1417,5,709,1,1117,,,,762,,,,5630,98,1713,2175,320,12,6,1369,2112,2207,1879,492,1387,328
2010,91,42091203804,42,135947.0,42,1047,20,414,192,32,855,5,331,2,650,,,,397,,,,3241,54,1263,937,163,19,9,501,1232,1196,1047,468,579,149
2010,91,42091203901,42,80000.0,42,1050,4,550,338,22,712,8,372,1,891,,,,159,,,,3709,19,1649,1645,89,44,8,982,918,1259,1050,208,842,209
2010,91,42091203902,42,85483.0,42,1458,108,465,298,33,1160,7,739,0,880,,,,578,,,,3536,183,1097,1233,129,11,2,654,1460,1686,1458,218,1240,228
2010,91,42091204002,42,86544.0,42,1401,104,157,45,13,1356,3,535,0,319,,,,1082,,,,3285,286,357,157,75,10,0,92,2465,1460,1401,816,585,59
2010,91,42091204007,42,88173.0,42,956,72,73,16,16,940,0,401,0,174,,,,782,,,,2257,217,164,45,34,1,0,13,1828,1007,956,500,456,51
2010,91,42091204008,42,67576.0,42,1190,57,46,26,15,1164,1,440,1,144,,,,1046,,,,2865,156,85,72,56,2,2,14,2550,1214,1190,793,397,24
2010,91,42091204009,42,68571.0,42,643,30,19,9,7,634,0,277,0,63,,,,580,,,,1439,82,83,27,26,0,0,1,1247,677,643,545,98,34
2010,91,42091204010,42,69034.0,42,941,38,32,6,2,935,1,180,0,79,,,,862,,,,2582,122,95,43,20,1,0,8,2336,950,941,917,24,9
2010,91,42091204101,42,120492.0,42,1979,16,38,37,13,1942,4,971,0,105,,,,1874,,,,4321,46,108,147,65,8,0,40,4054,2102,1979,1333,646,123
2010,91,42091204102,42,140167.0,42,1829,53,159,52,17,1777,1,1167,0,278,,,,1551,,,,3512,96,400,127,68,2,0,56,2890,2584,1829,827,1002,755
2010,91,42091204200,42,81545.0,42,587,12,19,14,7,573,3,277,0,55,,,,532,,,,1320,44,47,48,23,6,0,11,1189,658,587,421,166,71
2010,91,42091204300,42,87361.0,42,1152,62,61,24,9,1128,0,533,0,154,,,,998,,,,2434,165,143,78,41,2,2,17,2064,1322,1152,899,253,170
2010,91,42091204400,42,110092.0,42,1194,53,43,19,12,1175,3,265,0,131,,,,1063,,,,3241,148,92,68,59,5,0,10,2927,1250,1194,910,284,56
2010,91,42091204500,42,83345.0,42,1450,47,43,33,11,1417,0,303,0,131,,,,1319,,,,4752,168,120,155,62,2,0,17,4383,1519,1450,1320,130,69
2010,91,42091204600,42,110625.0,42,1567,70,25,23,6,1544,1,246,0,129,,,,1438,,,,4612,223,96,97,71,5,0,30,4187,1627,1567,1496,71,60
2010,91,42091204701,42,88191.0,42,1068,42,22,10,6,1058,0,492,0,82,,,,986,,,,2173,113,57,37,25,2,0,18,1958,1137,1068,893,175,69
2010,91,42091204702,42,89375.0,42,1296,69,30,28,11,1268,0,360,1,135,,,,1161,,,,3402,238,92,90,70,2,1,22,2977,1345,1296,1110,186,49
2010,91,42091204800,42,81458.0,42,1939,57,16,12,8,1927,0,490,0,94,,,,1845,,,,5020,205,70,84,53,0,0,18,4674,2112,1939,1676,263,173
2010,91,42091204900,42,82857.0,42,1765,50,23,28,4,1737,0,442,1,105,,,,1660,,,,5178,218,225,143,83,0,3,23,4626,1904,1765,1595,170,139
2010,91,42091205000,42,84615.0,42,757,32,72,25,13,732,2,385,0,142,,,,615,,,,2517,236,227,123,100,3,0,28,1923,837,757,389,368,80
2010,91,42091205100,42,81563.0,42,687,48,28,17,10,670,0,377,0,103,,,,584,,,,1853,166,183,63,42,0,2,13,1447,759,687,254,433,72
2010,91,42091205200,42,111848.0,42,1249,43,22,24,13,1225,0,520,0,104,,,,1145,,,,2848,122,39,63,46,0,0,16,2625,1345,1249,919,330,96
2010,91,42091205300,42,62689.0,42,891,35,243,32,22,859,1,536,0,333,,,,558,,,,1867,78,592,115,85,6,1,47,1058,988,891,332,559,97
2010,91,42091205400,42,177906.0,42,2609,209,94,77,25,2532,0,1035,1,397,,,,2212,,,,5990,566,186,210,111,2,2,55,5068,2790,2609,1473,1136,181
2010,91,42091205501,42,131875.0,42,1618,48,238,45,24,1573,2,782,2,349,,,,1269,,,,3514,132,672,166,87,8,8,41,2566,1806,1618,864,754,188
2010,91,42091205502,42,106450.0,42,1317,82,28,20,11,1297,0,257,0,140,,,,1177,,,,3565,268,70,84,58,0,0,11,3158,1356,1317,1258,59,39
2010,91,42091205503,42,90323.0,42,1902,138,105,29,16,1873,0,590,0,286,,,,1616,,,,4827,441,382,141,84,2,0,23,3895,1984,1902,1742,160,82
2010,91,42091205600,42,96500.0,42,1884,74,44,33,21,1851,0,786,1,170,,,,1714,,,,4314,191,83,102,121,2,3,15,3899,1995,1884,1148,736,111
2010,91,42091205700,42,79518.0,42,2008,44,171,165,31,1843,7,966,0,407,,,,1601,,,,4554,128,360,583,157,14,0,259,3636,2161,2008,957,1051,153
2010,91,42091205801,42,123333.0,42,1579,382,90,33,24,1546,1,990,0,530,,,,1049,,,,2643,851,149,77,53,5,0,24,1561,1739,1579,419,1160,160
2010,91,42091205805,42,114085.0,42,1229,146,46,34,11,1195,1,373,1,237,,,,992,,,,3070,469,131,136,62,10,1,65,2332,1280,1229,1015,214,51
2010,91,42091205806,42,118079.0,42,847,74,31,18,7,829,1,303,0,131,,,,716,,,,2050,213,87,89,45,2,0,51,1652,903,847,534,313,56
2010,91,42091205807,42,108869.0,42,1032,244,73,68,21,964,2,530,0,405,,,,627,,,,2248,626,150,233,78,10,0,126,1258,1237,1032,327,705,205
2010,91,42091205808,42,128289.0,42,1896,243,81,41,20,1855,2,446,0,381,,,,1515,,,,5340,806,254,157,107,11,0,19,4143,1942,1896,1691,205,46
2010,91,42091205809,42,73737.0,42,989,82,35,18,8,971,5,185,0,147,,,,842,,,,2811,291,117,78,40,10,2,23,2328,1008,989,944,45,19
2010,91,42091205903,42,115063.0,42,1013,50,41,16,7,997,2,208,0,115,,,,898,,,,2719,166,108,61,55,3,0,12,2375,1042,1013,976,37,29
2010,91,42091205904,42,37524.0,42,929,30,54,13,7,916,2,282,0,106,,,,823,,,,2141,85,128,52,41,3,0,10,1874,973,929,864,65,44
2010,91,42091205905,42,70363.0,42,1672,210,135,57,26,1615,2,927,0,422,,,,1250,,,,3436,532,311,158,75,7,0,32,2479,1798,1672,631,1041,126
2010,91,42091205906,42,70781.0,42,841,53,53,17,11,824,1,333,2,139,,,,702,,,,1937,145,116,68,43,2,4,35,1592,878,841,678,163,37
2010,91,42091206004,42,23134.0,42,1598,102,75,48,19,1550,3,448,0,242,,,,1356,,,,6147,371,1108,222,110,6,0,67,4485,1676,1598,1070,528,78
2010,91,42091206005,42,94146.0,42,1540,74,27,34,6,1506,2,323,0,140,,,,1400,,,,4397,281,95,158,34,4,0,61,3922,1584,1540,1414,126,44
2010,91,42091206006,42,,42,1449,30,24,11,9,1438,0,635,0,72,,,,1377,,,,3032,74,54,40,27,1,1,7,2868,1628,1449,984,465,179
2010,91,42091206007,42,121941.0,42,2191,342,94,43,21,2148,0,608,0,500,,,,1691,,,,6068,1056,391,174,79,3,1,57,4481,2300,2191,1524,667,109
2010,91,42091206102,42,95500.0,42,3214,307,132,54,22,3160,2,947,0,516,,,,2698,,,,8290,1000,324,196,142,11,0,32,6781,3319,3214,2837,377,105
2010,91,42091206104,42,115556.0,42,981,61,34,16,11,965,1,198,1,122,,,,859,,,,2940,193,109,97,58,7,3,12,2558,1004,981,898,83,23
2010,91,42091206105,42,47875.0,42,1470,82,38,23,11,1447,1,156,0,155,,,,1315,,,,5442,335,167,93,72,2,0,14,4852,1496,1470,1392,78,26
2010,91,42091206106,42,87083.0,42,1695,43,50,24,10,1671,1,424,0,125,,,,1570,,,,4547,138,136,82,55,8,1,20,4189,1730,1695,1479,216,35
2010,91,42091206201,42,59722.0,42,1249,18,57,31,14,1218,4,581,0,121,,,,1128,,,,2666,53,135,113,64,7,0,30,2377,1343,1249,650,599,94
2010,91,42091206202,42,64698.0,42,883,11,38,27,10,856,2,371,0,87,,,,796,,,,2086,27,106,87,49,4,0,16,1884,1008,883,418,465,125
2010,91,42091206300,42,73967.0,42,1378,39,40,24,7,1354,1,420,0,111,,,,1267,,,,5089,195,206,123,97,8,1,33,4549,1427,1378,1000,378,49
2010,91,42091206400,42,51172.0,42,1353,47,50,25,12,1328,2,374,1,135,,,,1218,,,,3509,157,113,95,70,9,1,29,3130,1407,1353,1096,257,54
2010,91,42091206501,42,65183.0,42,1323,96,63,28,15,1295,0,215,0,203,,,,1120,,,,4182,336,195,116,87,0,0,30,3534,1359,1323,1226,97,36
2010,91,42091206502,42,79531.0,42,1696,44,52,35,21,1661,1,382,0,148,,,,1548,,,,4957,137,177,150,106,3,0,21,4513,1748,1696,1501,195,52
2010,91,42091206600,42,76759.0,42,635,4,17,11,6,624,1,326,0,38,,,,597,,,,1385,10,34,38,19,1,1,6,1314,697,635,396,239,62
2010,91,42091206702,42,61282.0,42,5,0,0,0,0,5,0,2,0,0,,,,5,,,,3403,10,2040,401,2,0,0,390,961,6,5,4,1,1
2010,91,42091206703,42,66250.0,42,1405,44,23,28,9,1377,0,364,1,104,,,,1301,,,,3700,155,78,126,64,1,1,67,3334,1495,1405,1224,181,90
2010,91,42091206704,42,90612.0,42,2327,89,57,35,14,2292,2,459,0,196,,,,2131,,,,6612,332,153,124,100,6,1,28,5992,2444,2327,2114,213,117
2010,91,42091206801,42,48088.0,42,2424,222,62,29,11,2395,0,587,0,323,,,,2101,,,,6825,771,198,102,100,0,0,20,5736,2590,2424,2006,418,166
2010,91,42091206802,42,112991.0,42,1133,71,28,14,6,1119,1,293,0,120,,,,1013,,,,2925,229,73,57,29,1,2,15,2576,1184,1133,1019,114,51
2010,91,42091206901,42,102833.0,42,1827,189,92,47,24,1780,1,683,1,351,,,,1476,,,,4438,544,218,148,88,1,1,45,3541,1901,1827,967,860,74
2010,91,42091206904,42,84966.0,42,2448,122,99,37,19,2411,5,956,1,278,,,,2170,,,,5407,361,240,145,97,13,1,20,4675,2559,2448,1611,837,111
2010,91,42091206905,42,86177.0,42,1762,127,68,19,13,1743,1,421,0,231,,,,1531,,,,4780,447,180,87,65,4,0,26,4058,1801,1762,1620,142,39
2010,91,42091206906,42,106285.0,42,1250,39,36,18,12,1232,0,423,0,102,,,,1148,,,,2953,126,89,53,38,1,1,14,2684,1285,1250,1060,190,35
2010,91,42091207001,42,87950.0,42,2674,109,88,46,14,2628,2,482,1,257,,,,2417,,,,7792,400,271,209,100,6,2,58,6955,2777,2674,2199,475,103
2010,91,42091207003,42,90190.0,42,1131,44,30,17,8,1114,0,355,0,96,,,,1035,,,,2897,123,67,58,38,0,0,12,2657,1179,1131,710,421,48
2010,91,42091207004,42,119500.0,42,1655,40,40,34,10,1621,1,503,0,123,,,,1532,,,,4270,141,98,117,60,3,0,30,3938,1708,1655,1210,445,53
2010,91,42091207101,42,92952.0,42,2039,58,22,18,12,2021,3,423,2,114,,,,1925,,,,5783,193,67,98,95,9,5,29,5385,2106,2039,1585,454,67
2010,91,42091207103,42,78235.0,42,1410,37,30,15,3,1395,3,225,0,89,,,,1321,,,,4095,163,110,93,41,6,0,18,3757,1446,1410,1299,111,36
2010,91,42091207104,42,55938.0,42,1212,17,9,9,5,1203,0,342,0,38,,,,1174,,,,3186,79,36,38,16,7,1,8,3039,1249,1212,1093,119,37
2010,91,42091207201,42,75938.0,42,969,25,29,64,12,905,3,299,1,130,,,,839,,,,2502,93,78,224,65,5,1,66,2194,1013,969,613,356,44
2010,91,42091207202,42,67011.0,42,1672,57,36,146,29,1526,7,595,1,252,,,,1420,,,,4116,217,90,537,105,12,1,220,3471,1743,1672,933,739,71
2010,91,42091207300,42,50774.0,42,998,31,30,65,12,933,1,287,2,135,,,,863,,,,2665,156,93,259,59,1,4,87,2265,1056,998,628,370,58
2010,91,42091207400,42,50205.0,42,888,4,7,7,2,881,4,167,0,23,,,,865,,,,2504,24,20,32,17,5,0,13,2425,923,888,796,92,35
2010,91,42091207500,42,54599.0,42,1154,7,9,14,6,1140,0,216,0,36,,,,1118,,,,3299,33,45,61,33,1,0,19,3168,1199,1154,1013,141,45
2010,91,42091207600,42,52250.0,42,1489,2,12,11,5,1478,5,429,0,36,,,,1453,,,,3686,8,41,42,31,7,0,10,3589,1580,1489,1265,224,91
2010,91,42091207800,42,68398.0,42,2354,18,23,25,5,2329,1,472,3,70,,,,2284,,,,6464,94,98,119,44,2,8,34,6184,2424,2354,2163,191,70
2010,91,42091207900,42,52188.0,42,1100,6,14,15,9,1085,0,470,0,43,,,,1057,,,,2383,16,33,50,32,0,0,5,2297,1141,1100,747,353,41
2010,91,42091208000,42,82037.0,42,1286,12,18,34,6,1252,0,366,1,69,,,,1217,,,,3843,201,78,159,53,3,3,47,3458,1317,1286,872,414,31
2010,91,42091208100,42,79600.0,42,1117,5,18,23,12,1094,3,340,0,57,,,,1060,,,,2951,29,67,97,56,4,1,28,2766,1173,1117,740,377,56
2010,91,42091208201,42,112614.0,42,786,0,2,3,3,783,0,149,0,8,,,,778,,,,2187,8,5,12,21,0,1,3,2149,811,786,717,69,25
2010,91,42091208203,42,136087.0,42,1655,11,26,29,10,1626,3,431,0,76,,,,1579,,,,4364,47,62,109,61,6,0,13,4175,1731,1655,1179,476,76
2010,91,42091208204,42,56953.0,42,1171,18,12,9,3,1162,3,172,0,47,,,,1124,,,,3644,62,39,66,40,22,1,21,3459,1198,1171,1079,92,27
2010,91,42091208301,42,105861.0,42,1014,4,4,4,5,1010,1,234,0,18,,,,996,,,,2639,18,19,47,41,1,0,5,2555,1061,1014,925,89,47
2010,91,42091208302,42,81818.0,42,2783,49,43,36,14,2747,4,392,0,137,,,,2646,,,,8300,200,111,125,86,8,2,21,7872,2858,2783,2663,120,75
2010,91,42091208400,42,70613.0,42,1379,5,21,20,7,1359,1,426,1,55,,,,1324,,,,3523,22,54,71,36,5,5,17,3384,1450,1379,1116,263,71
2010,91,42091208500,42,58567.0,42,1834,24,34,35,7,1799,5,477,0,101,,,,1733,,,,4840,66,95,145,50,15,2,46,4566,1908,1834,1618,216,74
2010,91,42091208601,42,50882.0,42,2214,50,56,27,9,2187,3,514,1,145,,,,2069,,,,6127,188,144,93,73,8,3,12,5699,2305,2214,1919,295,91
2010,91,42091208603,42,122857.0,42,2473,52,93,22,14,2451,2,727,0,182,,,,2291,,,,6479,158,249,112,81,8,1,26,5956,2560,2473,2056,417,87
2010,91,42091208604,42,110956.0,42,2205,80,92,32,20,2173,2,840,0,230,,,,1975,,,,5468,229,218,113,86,6,1,40,4888,2334,2205,1560,645,129
2010,91,42091208702,42,90133.0,42,1283,14,35,19,4,1264,0,251,1,69,,,,1214,,,,3469,31,107,64,49,0,1,1,3280,1326,1283,1216,67,43
2010,91,42091208703,42,130179.0,42,1516,13,54,18,6,1498,1,431,1,91,,,,1425,,,,3857,56,166,87,52,6,3,20,3554,1573,1516,1319,197,57
2010,91,42091208704,42,130026.0,42,1698,32,310,51,24,1647,2,491,1,405,,,,1293,,,,4733,104,947,175,188,5,3,30,3456,1752,1698,1201,497,54
2010,91,42091208801,42,97988.0,42,520,3,82,33,16,487,3,271,0,131,,,,389,,,,1178,4,226,129,68,6,0,51,823,602,520,152,368,82
2010,91,42091208802,42,87955.0,42,1348,8,128,45,25,1303,3,549,1,203,,,,1145,,,,3225,30,376,161,117,4,4,54,2640,1441,1348,807,541,93
2010,91,42091208901,42,75402.0,42,1541,7,174,59,26,1482,3,636,0,256,,,,1285,,,,3537,26,502,186,130,7,2,54,2816,1697,1541,959,582,156
2010,91,42091208903,42,154087.0,42,1191,12,291,41,23,1150,1,416,1,360,,,,831,,,,2991,31,809,167,127,6,4,52,1962,1299,1191,765,426,108
2010,91,42091208904,42,72581.0,42,1379,13,382,146,40,1233,7,706,1,568,,,,811,,,,3297,36,1027,476,199,22,2,177,1834,1633,1379,308,1071,254
2010,91,42091208905,42,70571.0,42,1170,4,58,37,18,1133,0,462,0,108,,,,1062,,,,2586,19,135,115,68,2,0,25,2337,1273,1170,897,273,103
2010,91,42091208906,42,67868.0,42,1523,12,301,88,16,1435,4,568,0,406,,,,1117,,,,3931,36,878,349,168,20,0,146,2683,1696,1523,925,598,173
2010,91,42091209000,42,59940.0,42,649,2,149,57,19,592,1,211,1,216,,,,433,,,,1632,15,413,202,108,4,3,41,1048,679,649,339,310,30
2010,91,42091209100,42,84817.0,42,1858,30,95,35,22,1823,5,372,2,181,,,,1677,,,,5315,125,306,143,104,12,3,29,4736,1950,1858,1677,181,92
2010,91,42091209201,42,91250.0,42,604,6,40,16,10,588,1,183,0,69,,,,535,,,,1587,18,138,49,41,7,0,10,1373,642,604,419,185,38
2010,91,42091209202,42,79167.0,42,920,2,72,22,13,898,2,330,1,110,,,,810,,,,2287,6,229,78,73,4,1,25,1949,971,920,601,319,51
2010,91,42091210100,42,66389.0,42,1494,31,64,34,13,1460,3,397,0,141,,,,1353,,,,3871,114,187,131,70,4,0,45,3451,1528,1494,1177,317,34
2010,91,42091210200,42,81450.0,42,1045,20,103,14,9,1031,0,218,0,144,,,,901,,,,2786,77,275,64,50,1,1,21,2361,1066,1045,1014,31,21
2010,91,42091210300,42,78893.0,42,1507,40,48,15,10,1492,1,533,0,112,,,,1395,,,,3921,97,271,71,40,4,0,8,3501,1585,1507,1173,334,78
2010,91,42091210400,42,58711.0,42,1918,41,258,29,19,1889,3,763,0,349,,,,1569,,,,4597,139,704,101,74,6,1,35,3638,2007,1918,1365,553,89
2010,91,42091210500,42,88092.0,42,1586,27,191,18,20,1568,3,510,0,257,,,,1329,,,,4243,116,720,95,88,10,0,25,3284,1635,1586,1315,271,49
2010,91,42091210600,42,70724.0,42,1627,114,118,23,11,1604,1,540,0,264,,,,1363,,,,4097,325,374,85,66,9,0,15,3308,1712,1627,1189,438,85
2010,91,42091210700,42,73162.0,42,1991,187,49,34,16,1957,3,371,0,287,,,,1704,,,,5792,697,152,136,72,8,0,14,4849,2039,1991,1777,214,48
2010,101,42101000100,42,66695.0,42,2301,104,150,76,42,2225,7,1791,1,371,,,,1930,,,,3478,174,212,126,79,8,2,35,2968,2696,2301,818,1483,395
2010,101,42101000200,42,80174.0,42,1145,734,29,29,16,1116,0,620,0,805,,,,340,,,,2937,1856,295,79,45,3,1,26,711,1285,1145,364,781,140
2010,101,42101000300,42,98200.0,42,1855,175,234,79,39,1776,1,1362,1,528,,,,1327,,,,3169,329,328,135,85,1,1,39,2386,1968,1855,453,1402,113
2010,101,42101000401,42,115729.0,42,1584,366,317,77,54,1507,8,1320,0,812,,,,772,,,,2125,520,382,107,70,11,0,20,1122,1790,1584,344,1240,206
2010,101,42101000402,42,89236.0,42,2273,241,101,63,24,2210,4,1806,2,433,,,,1840,,,,3142,356,176,109,42,4,4,26,2534,2709,2273,1386,887,436
2010,101,42101000500,42,38948.0,42,684,174,60,28,21,656,4,576,1,288,,,,396,,,,2329,341,899,306,60,12,2,56,959,797,684,45,639,113
2010,101,42101000600,42,87083.0,42,723,91,45,31,17,692,0,602,0,187,,,,536,,,,1781,162,265,142,73,1,0,48,1232,814,723,29,694,91
2010,101,42101000700,42,63438.0,42,2176,319,205,99,57,2077,3,1832,0,670,,,,1506,,,,3082,468,287,142,83,6,0,33,2205,2489,2176,556,1620,313
2010,101,42101000801,42,104476.0,42,1017,109,34,50,17,967,0,758,1,209,,,,808,,,,1562,169,49,90,34,4,4,13,1289,1078,1017,294,723,61
2010,101,42101000803,42,94351.0,42,2590,326,54,86,46,2504,1,2059,2,501,,,,2089,,,,3601,443,75,122,82,2,3,13,2983,2844,2590,967,1623,254
2010,101,42101000804,42,87237.0,42,2589,314,78,111,50,2478,1,2068,1,554,,,,2035,,,,3609,424,99,179,73,1,1,26,2985,3066,2589,613,1976,477
2010,101,42101000901,42,111250.0,42,1729,278,160,66,52,1663,4,1548,1,559,,,,1170,,,,2276,352,223,94,76,4,1,40,1580,1877,1729,172,1557,148
2010,101,42101000902,42,120871.0,42,1419,319,126,48,23,1371,2,1049,2,511,,,,908,,,,2773,640,172,112,70,3,2,17,1869,1582,1419,230,1189,163
2010,101,42101001001,42,101429.0,42,1600,69,42,42,17,1558,0,1044,0,170,,,,1430,,,,2603,132,70,72,35,0,0,18,2348,1733,1600,1031,569,133
2010,101,42101001002,42,109680.0,42,2099,117,47,64,31,2035,2,1350,1,259,,,,1840,,,,3612,220,94,120,74,5,2,33,3184,2348,2099,1253,846,249
2010,101,42101001101,42,82591.0,42,2097,133,186,73,33,2024,1,1765,1,424,,,,1673,,,,3586,229,348,162,97,3,3,21,2885,2263,2097,657,1440,166
2010,101,42101001102,42,117344.0,42,1624,109,73,50,33,1574,0,1226,1,259,,,,1365,,,,2659,187,134,109,86,3,1,20,2228,1741,1624,564,1060,117
2010,101,42101001201,42,101176.0,42,2052,121,49,66,32,1986,1,1282,1,265,,,,1787,,,,3778,222,87,145,86,6,1,33,3343,2193,2052,1046,1006,141
2010,101,42101001202,42,128611.0,42,3131,202,157,134,73,2997,5,2418,1,561,,,,2570,,,,5137,321,291,262,138,9,3,45,4330,3529,3131,843,2288,398
2010,101,42101001300,42,111932.0,42,2470,117,751,71,54,2399,5,1527,1,995,,,,1475,,,,4942,243,1583,182,162,13,1,54,2886,2868,2470,1388,1082,398
2010,101,42101001400,42,123438.0,42,2129,100,586,83,47,2046,5,1545,1,813,,,,1316,,,,3950,222,1034,208,110,7,1,77,2499,2373,2129,843,1286,244
2010,101,42101001500,42,93873.0,42,1336,76,200,68,23,1268,0,849,0,367,,,,969,,,,2708,185,458,172,74,0,2,37,1952,1545,1336,686,650,209
2010,101,42101001600,42,73846.0,42,1162,42,60,42,20,1120,2,757,1,162,,,,1000,,,,2192,95,113,120,80,3,2,28,1871,1294,1162,487,675,132
2010,101,42101001700,42,70991.0,42,1392,42,88,39,18,1353,0,854,0,188,,,,1204,,,,2647,97,163,100,61,4,1,39,2282,1498,1392,773,619,106
2010,101,42101001800,42,60256.0,42,1382,66,207,54,26,1328,2,792,0,349,,,,1033,,,,2873,174,559,133,74,2,0,42,2022,1628,1382,736,646,246
2010,101,42101001900,42,75246.0,42,1292,63,514,79,30,1213,6,833,1,674,,,,618,,,,2721,121,1108,194,69,8,3,67,1345,1524,1292,673,619,232
2010,101,42101002000,42,59360.0,42,861,13,763,22,18,839,3,388,0,809,,,,52,,,,2092,36,1831,70,63,8,0,22,132,1066,861,458,403,205
2010,101,42101002100,42,56037.0,42,840,5,683,25,24,815,2,396,0,733,,,,107,,,,2036,12,1630,108,65,7,1,52,269,1090,840,483,357,250
2010,101,42101002200,42,40891.0,42,1018,38,575,60,36,958,5,588,0,699,,,,319,,,,2281,97,1405,175,83,10,0,89,597,1270,1018,445,573,252
2010,101,42101002300,42,60139.0,42,1232,123,61,104,25,1128,2,715,0,313,,,,919,,,,2682,383,128,376,63,3,1,257,1847,1348,1232,645,587,116
2010,101,42101002400,42,43819.0,42,2273,271,185,235,43,2038,10,1268,3,720,,,,1553,,,,5129,814,453,912,141,55,4,432,3230,2538,2273,1175,1098,265
2010,101,42101002500,42,43682.0,42,1669,95,536,96,39,1573,4,849,0,747,,,,922,,,,3769,268,1350,293,111,10,2,96,1932,1818,1669,754,915,149
2010,101,42101002701,42,48299.0,42,1463,283,362,224,32,1239,11,705,0,889,,,,574,,,,3874,1006,885,800,131,32,0,490,1330,1677,1463,608,855,214
2010,101,42101002702,42,34210.0,42,1704,39,48,58,23,1646,1,933,0,166,,,,1538,,,,3566,101,128,148,64,1,0,40,3232,1895,1704,1087,617,191
2010,101,42101002801,42,34012.0,42,1561,401,143,298,36,1263,12,681,0,860,,,,701,,,,4324,1367,349,1256,158,44,0,729,1677,1774,1561,745,816,213
2010,101,42101002802,42,31019.0,42,2269,299,32,159,34,2110,3,1072,0,517,,,,1752,,,,5539,1075,74,739,114,6,1,415,3854,2496,2269,1435,834,227
2010,101,42101002900,42,64318.0,42,2047,92,57,89,33,1958,1,1172,0,271,,,,1776,,,,4141,306,106,262,126,2,0,106,3495,2225,2047,1276,771,178
2010,101,42101003001,42,60556.0,42,1614,639,386,85,36,1529,1,605,3,1141,,,,473,,,,4664,2293,1024,338,155,11,9,208,964,1803,1614,865,749,189
2010,101,42101003002,42,73147.0,42,1320,108,840,72,31,1248,8,649,0,1045,,,,275,,,,3200,330,2007,263,93,17,1,164,588,1567,1320,610,710,247
2010,101,42101003100,42,63125.0,42,1840,61,1629,40,26,1800,4,779,2,1746,,,,94,,,,4437,191,3862,122,82,18,7,57,220,2343,1840,969,871,503
2010,101,42101003200,42,107823.0,42,1797,11,1636,29,35,1768,5,638,1,1707,,,,90,,,,4875,44,4431,100,132,13,1,47,207,2271,1797,960,837,474
2010,101,42101003300,42,65858.0,42,2295,77,1421,53,30,2242,8,821,0,1570,,,,725,,,,6162,235,4073,197,147,21,0,72,1614,2761,2295,1124,1171,466
2010,101,42101003600,42,70909.0,42,2635,247,1536,97,48,2538,9,971,2,1906,,,,729,,,,6723,908,4029,322,160,25,2,124,1475,2803,2635,1089,1546,168
2010,101,42101003701,42,99000.0,42,2259,248,1657,66,51,2193,6,695,1,2008,,,,251,,,,6609,852,4888,268,171,18,2,87,591,2663,2259,1173,1086,404
2010,101,42101003702,42,81875.0,42,1350,194,597,47,22,1303,2,440,0,851,,,,499,,,,3707,698,1752,186,125,5,1,74,1052,1486,1350,857,493,136
2010,101,42101003800,42,131607.0,42,1645,47,30,27,11,1618,2,628,0,116,,,,1529,,,,3898,196,72,118,51,7,0,33,3539,1723,1645,1335,310,78
2010,101,42101003901,42,159400.0,42,2674,324,247,121,45,2553,6,1336,0,721,,,,1953,,,,6062,1104,590,384,142,16,4,166,4040,2936,2674,1515,1159,262
2010,101,42101003902,42,201537.0,42,2448,24,9,31,20,2417,3,995,0,80,,,,2368,,,,5507,80,19,99,58,4,0,21,5325,2630,2448,1957,491,182
2010,101,42101004001,42,118214.0,42,1915,143,44,96,28,1819,6,961,3,311,,,,1604,,,,4259,517,98,352,106,13,6,139,3380,2091,1915,1220,695,176
2010,101,42101004002,42,120281.0,42,2193,62,7,42,15,2151,2,885,0,125,,,,2068,,,,4998,209,25,208,62,5,1,56,4640,2362,2193,1647,546,169
2010,101,42101004101,42,176944.0,42,2146,564,519,299,67,1847,11,804,2,1416,,,,730,,,,6243,2097,1325,1288,268,40,9,737,1767,2447,2146,1075,1071,301
2010,101,42101004102,42,184875.0,42,2688,633,268,259,58,2429,7,892,4,1192,,,,1496,,,,7848,2375,841,1125,282,24,11,680,3635,2981,2688,1461,1227,293
2010,101,42101004201,42,53750.0,42,2067,123,105,82,28,1985,2,797,1,333,,,,1734,,,,5105,436,290,274,95,3,1,106,4174,2284,2067,1517,550,217
2010,101,42101004202,42,79539.0,42,1800,152,82,75,28,1725,5,533,2,333,,,,1467,,,,4925,544,258,300,140,9,2,91,3881,1925,1800,1424,376,125
2010,101,42101005000,42,108125.0,42,1,0,0,1,0,0,0,0,0,1,,,,0,,,,13,0,1,4,0,0,0,4,8,1,1,0,1,0
2010,101,42101005400,42,53926.0,42,628,32,476,21,14,607,3,303,2,538,,,,90,,,,1314,73,1007,49,33,3,6,25,167,689,628,237,391,61
2010,101,42101005500,42,87781.0,42,2258,64,1757,54,45,2204,5,820,1,1909,,,,349,,,,5635,203,4466,152,147,9,1,59,750,2429,2258,1562,696,171
2010,101,42101005600,42,55685.0,42,542,15,451,12,13,530,1,251,0,487,,,,55,,,,1111,41,938,26,31,3,1,1,96,587,542,88,454,45
2010,101,42101006000,42,144659.0,42,2427,119,1618,46,40,2381,6,844,0,1825,,,,602,,,,6450,416,4620,170,122,28,0,114,1150,2617,2427,1623,804,190
2010,101,42101006100,42,95893.0,42,1130,84,802,15,17,1115,1,318,0,915,,,,215,,,,3123,292,2326,49,59,6,0,26,414,1213,1130,888,242,83
2010,101,42101006200,42,81929.0,42,1429,64,1126,32,24,1397,2,328,1,1235,,,,194,,,,4524,221,3737,107,98,8,2,31,427,1592,1429,945,484,163
2010,101,42101006300,42,46350.0,42,1344,165,1003,51,24,1293,5,457,1,1237,,,,107,,,,4236,618,3150,189,88,15,2,110,253,1620,1344,520,824,276
2010,101,42101006400,42,57794.0,42,1417,127,1077,39,26,1378,2,383,1,1257,,,,160,,,,4472,527,3410,146,123,12,1,57,342,1586,1417,887,530,169
2010,101,42101006500,42,63818.0,42,1681,7,1620,21,22,1660,9,592,1,1663,,,,18,,,,4486,23,4291,78,91,22,5,21,33,2088,1681,971,710,407
2010,101,42101006600,42,59631.0,42,1357,125,1079,43,29,1314,5,574,1,1269,,,,88,,,,3750,421,2957,149,91,11,2,69,199,1571,1357,513,844,214
2010,101,42101006700,42,73920.0,42,2495,160,1833,76,58,2419,7,703,3,2109,,,,386,,,,7472,545,5746,279,206,25,5,151,794,2804,2495,1362,1133,309
2010,101,42101006900,42,102813.0,42,996,2,937,20,19,976,4,327,0,969,,,,27,,,,2539,3,2406,55,36,13,0,20,61,1093,996,298,698,97
2010,101,42101007000,42,105208.0,42,1475,9,1411,7,15,1468,3,513,0,1443,,,,32,,,,3990,29,3807,40,68,9,1,20,56,1715,1475,879,596,240
2010,101,42101007101,42,123185.0,42,882,11,835,14,19,868,1,298,0,870,,,,12,,,,2557,23,2326,40,62,7,0,10,129,1093,882,457,425,211
2010,101,42101007102,42,134286.0,42,1776,7,1715,22,26,1754,4,545,0,1761,,,,15,,,,4924,19,4747,70,87,15,0,24,32,2042,1776,1156,620,266
2010,101,42101007200,42,66112.0,42,1730,9,1645,30,35,1700,7,587,0,1703,,,,27,,,,4773,41,4530,115,93,19,0,23,67,2040,1730,1088,642,310
2010,101,42101007300,42,88661.0,42,1117,11,969,25,34,1092,7,416,2,1037,,,,80,,,,3088,30,2723,81,91,9,3,40,192,1351,1117,579,538,234
2010,101,42101007400,42,87692.0,42,1667,22,1469,29,31,1638,4,714,0,1545,,,,122,,,,4338,62,3821,120,87,8,0,60,300,2031,1667,832,835,364
2010,101,42101007700,42,81840.0,42,775,170,273,12,15,763,7,560,3,480,,,,295,,,,2380,583,703,51,61,14,3,28,988,899,775,138,637,124
2010,101,42101007800,42,69306.0,42,2017,117,720,86,59,1931,7,1401,0,969,,,,1048,,,,4177,245,1510,203,163,13,1,38,2207,2315,2017,538,1479,298
2010,101,42101007900,42,91230.0,42,2116,100,792,101,80,2015,8,1271,5,1063,,,,1053,,,,4553,258,1735,242,214,24,5,68,2249,2301,2116,769,1347,185
2010,101,42101008000,42,110417.0,42,1549,18,1302,34,39,1515,4,648,1,1382,,,,167,,,,3951,46,3331,138,122,12,1,50,389,1909,1549,840,709,360
2010,101,42101008101,42,115313.0,42,1025,6,973,18,22,1007,4,343,0,1011,,,,14,,,,2758,12,2635,48,55,8,0,15,33,1190,1025,660,365,165
2010,101,42101008102,42,142625.0,42,1871,5,1799,26,33,1845,6,599,0,1851,,,,20,,,,5028,10,4847,101,100,10,0,21,40,2083,1871,1301,570,212
2010,101,42101008200,42,97688.0,42,2609,12,2507,32,51,2577,9,902,2,2594,,,,15,,,,6797,44,6512,125,126,16,3,44,52,2928,2609,1941,668,319
2010,101,42101008301,42,45036.0,42,1626,22,1541,20,29,1606,6,757,2,1606,,,,20,,,,4081,41,3806,85,82,18,3,12,119,1935,1626,924,702,309
2010,101,42101008302,42,58281.0,42,1751,12,1672,38,30,1713,15,671,0,1739,,,,12,,,,4307,40,4111,109,71,36,0,18,31,2134,1751,985,766,383
2010,101,42101008400,42,104896.0,42,1731,5,1651,29,36,1702,8,624,0,1714,,,,17,,,,4488,22,4246,90,119,21,0,31,49,2041,1731,1021,710,310
2010,101,42101008500,42,75321.0,42,2605,21,2398,43,54,2562,18,1119,2,2514,,,,91,,,,6313,88,5762,131,129,51,8,45,230,3171,2605,1172,1433,566
2010,101,42101008601,42,107188.0,42,1416,112,516,57,45,1359,10,932,0,735,,,,681,,,,2947,293,1076,118,99,20,1,28,1430,1637,1416,335,1081,221
2010,101,42101008602,42,97247.0,42,1345,35,1104,44,36,1301,10,712,0,1214,,,,131,,,,3010,106,2421,108,84,24,0,47,328,1548,1345,306,1039,203
2010,101,42101008701,42,50479.0,42,1983,411,343,94,83,1889,4,1432,3,922,,,,1061,,,,4147,1060,673,217,174,16,5,71,2148,2116,1983,259,1724,133
2010,101,42101008702,42,,42,1512,360,165,72,42,1440,0,1265,0,629,,,,883,,,,3036,667,393,196,102,6,1,46,1821,1598,1512,140,1372,86
2010,101,42101008801,42,113607.0,42,184,85,9,10,5,174,0,165,0,107,,,,77,,,,988,298,91,55,33,2,0,9,555,190,184,0,184,6
2010,101,42101008802,42,106823.0,42,1798,536,175,97,76,1701,7,1616,2,885,,,,913,,,,6983,1890,806,350,308,10,4,67,3898,1927,1798,37,1761,129
2010,101,42101009000,42,121330.0,42,1413,256,145,44,39,1369,7,1212,0,492,,,,921,,,,5576,956,444,231,146,16,2,75,3937,1528,1413,122,1291,115
2010,101,42101009100,42,95156.0,42,1535,211,678,48,43,1487,2,1209,0,970,,,,565,,,,2803,361,1171,99,86,7,0,38,1140,1746,1535,222,1313,211
2010,101,42101009200,42,58625.0,42,1220,55,956,30,31,1190,2,612,1,1063,,,,157,,,,2884,188,2223,97,85,12,3,28,345,1488,1220,378,842,268
2010,101,42101009300,42,63245.0,42,1711,7,1617,35,31,1676,13,731,1,1683,,,,28,,,,4221,27,3974,94,87,21,1,32,79,2217,1711,856,855,506
2010,101,42101009400,42,95724.0,42,1724,2,1662,24,30,1700,6,858,0,1710,,,,14,,,,3827,8,3687,76,74,9,0,21,28,1984,1724,586,1138,260
2010,101,42101009500,42,86932.0,42,1299,1,1250,17,25,1282,9,504,2,1293,,,,6,,,,3313,4,3180,66,64,23,2,22,18,1587,1299,645,654,288
2010,101,42101009600,42,107003.0,42,1686,15,1590,23,35,1663,8,635,0,1658,,,,28,,,,4238,27,4000,82,100,20,0,13,78,2059,1686,883,803,373
2010,101,42101009801,42,94449.0,42,886,17,710,11,15,875,0,309,0,753,,,,133,,,,2184,41,1807,44,60,4,0,22,250,976,886,581,305,90
2010,101,42101009802,42,70536.0,42,2169,35,1738,42,31,2127,4,684,1,1833,,,,336,,,,5475,104,4605,125,106,6,3,29,622,2261,2169,1640,529,92
2010,101,42101010000,42,83884.0,42,1636,14,1311,48,28,1588,12,589,1,1399,,,,237,,,,4366,63,3665,153,61,25,3,61,488,1804,1636,1066,570,168
2010,101,42101010100,42,97651.0,42,2209,9,2091,33,39,2176,12,891,0,2167,,,,42,,,,5459,39,5149,129,96,24,0,42,109,2643,2209,1320,889,434
2010,101,42101010200,42,64138.0,42,1281,2,1237,12,23,1269,6,523,0,1271,,,,10,,,,3187,7,3075,34,49,19,1,15,21,1485,1281,555,726,204
2010,101,42101010300,42,62500.0,42,964,5,924,19,20,945,5,374,0,959,,,,5,,,,2449,14,2331,57,64,9,0,11,20,1200,964,492,472,236
2010,101,42101010400,42,55536.0,42,1171,0,1121,14,18,1157,4,462,0,1156,,,,15,,,,3332,6,3125,113,58,11,0,36,96,1477,1171,573,598,306
2010,101,42101010500,42,75962.0,42,1489,4,1422,28,21,1461,7,777,0,1468,,,,21,,,,3746,20,3493,84,79,19,0,30,105,1666,1489,435,1054,177
2010,101,42101010600,42,86875.0,42,666,10,611,9,17,657,3,374,0,648,,,,18,,,,1476,35,1331,15,53,4,0,11,42,816,666,204,462,150
2010,101,42101010700,42,96859.0,42,1330,4,1261,26,18,1304,10,584,0,1307,,,,23,,,,3562,10,3388,79,43,19,0,24,78,1702,1330,440,890,372
2010,101,42101010800,42,71532.0,42,1362,16,1170,39,39,1323,11,564,1,1260,,,,102,,,,3611,47,3154,87,97,17,1,35,260,1807,1362,509,853,445
2010,101,42101010900,42,84272.0,42,879,27,677,22,12,857,6,448,1,735,,,,144,,,,2313,74,1747,58,44,17,3,14,414,1034,879,248,631,155
2010,101,42101011000,42,55345.0,42,1453,3,1365,28,19,1425,4,680,0,1408,,,,45,,,,3470,7,3248,98,67,9,1,30,108,1846,1453,525,928,393
2010,101,42101011100,42,62500.0,42,1399,10,1322,22,20,1377,10,579,1,1370,,,,29,,,,3712,37,3496,82,52,22,1,24,80,1753,1399,702,697,354
2010,101,42101011200,42,59931.0,42,2076,10,1997,24,36,2052,12,714,0,2061,,,,15,,,,5494,17,5250,100,134,29,0,17,47,2455,2076,1311,765,379
2010,101,42101011300,42,77537.0,42,1184,3,1142,16,25,1168,2,437,0,1177,,,,7,,,,2917,15,2780,49,75,8,0,10,29,1350,1184,818,366,166
2010,101,42101011400,42,64890.0,42,2564,14,2396,46,51,2518,14,1030,0,2493,,,,71,,,,6126,51,5700,134,141,38,0,37,159,2926,2564,1474,1090,362
2010,101,42101011500,42,92936.0,42,1580,13,1309,41,28,1539,5,481,1,1378,,,,202,,,,4282,40,3706,154,92,14,1,39,390,1696,1580,1204,376,116
2010,101,42101011700,42,81810.0,42,378,3,252,7,14,371,2,145,0,278,,,,100,,,,1931,29,716,57,38,5,0,23,1120,401,378,286,92,23
2010,101,42101011800,42,99673.0,42,2186,8,2056,25,41,2161,9,709,1,2129,,,,57,,,,5621,29,5261,94,105,27,3,40,156,2340,2186,1740,446,154
2010,101,42101011900,42,85494.0,42,2168,12,2014,37,51,2131,14,930,2,2109,,,,59,,,,5195,35,4816,127,127,25,3,40,149,2431,2168,1142,1026,263
2010,101,42101012000,42,82963.0,42,702,16,499,19,17,683,4,376,1,547,,,,155,,,,1947,51,1076,64,46,8,1,21,744,760,702,330,372,58
2010,101,42101012100,42,92361.0,42,1190,60,803,15,26,1175,6,732,0,907,,,,283,,,,2547,108,1702,54,59,9,0,19,650,1588,1190,473,717,398
2010,101,42101012201,42,78955.0,42,2053,271,809,61,61,1992,8,1647,0,1203,,,,850,,,,2911,437,1102,112,109,9,0,36,1218,2409,2053,3,2050,356
2010,101,42101012203,42,81919.0,42,672,153,171,21,20,651,0,554,0,368,,,,304,,,,1120,255,341,37,35,3,0,29,457,894,672,2,670,222
2010,101,42101012204,42,102716.0,42,1774,59,1158,40,50,1734,3,1104,0,1296,,,,478,,,,3564,112,2393,92,100,8,2,25,924,1925,1774,966,808,151
2010,101,42101012500,42,82232.0,42,3302,460,352,170,71,3132,7,2642,1,1039,,,,2263,,,,5210,801,584,281,126,11,2,70,3616,3555,3302,547,2755,253
2010,101,42101013100,42,72683.0,42,682,22,451,38,14,644,4,347,2,518,,,,164,,,,1529,43,1114,106,46,6,2,29,289,785,682,195,487,103
2010,101,42101013200,42,23250.0,42,963,33,804,64,14,899,8,458,1,905,,,,58,,,,2914,97,2365,223,65,13,2,75,297,1025,963,206,757,62
2010,101,42101013300,42,55705.0,42,1427,77,415,104,39,1323,6,1000,2,626,,,,801,,,,2854,125,1100,240,86,10,2,109,1422,1637,1427,305,1122,210
2010,101,42101013401,42,47830.0,42,1419,33,55,34,8,1385,3,954,0,128,,,,1291,,,,2288,62,80,66,27,4,1,4,2110,1567,1419,876,543,148
2010,101,42101013402,42,49917.0,42,1641,66,171,138,48,1503,3,1183,1,406,,,,1235,,,,2922,130,330,347,93,11,1,150,2207,1730,1641,522,1119,89
2010,101,42101013500,42,28875.0,42,1401,32,484,87,18,1314,1,704,0,613,,,,788,,,,3222,78,1267,251,74,6,0,110,1687,1582,1401,764,637,181
2010,101,42101013601,42,47708.0,42,1480,62,53,46,23,1434,0,907,0,180,,,,1300,,,,2677,117,86,96,68,0,0,18,2388,1580,1480,959,521,100
2010,101,42101013602,42,39615.0,42,1798,58,128,53,26,1745,2,1072,0,258,,,,1540,,,,3503,115,273,132,88,5,0,25,2997,1929,1798,1106,692,131
2010,101,42101013700,42,25500.0,42,1993,28,1477,57,45,1936,3,922,0,1584,,,,409,,,,4813,80,3716,164,129,7,3,45,833,2461,1993,1008,985,468
2010,101,42101013800,42,90320.0,42,827,5,728,19,13,808,2,363,0,763,,,,64,,,,2061,19,1828,73,47,6,0,34,127,1085,827,380,447,258
2010,101,42101013900,42,64225.0,42,1287,10,1096,47,29,1240,3,616,0,1164,,,,123,,,,3764,32,3106,212,81,10,2,57,476,1465,1287,183,1104,178
2010,101,42101014000,42,44732.0,42,1268,47,962,59,25,1209,7,785,1,1092,,,,176,,,,3010,120,2306,172,70,12,4,59,439,1561,1268,247,1021,293
2010,101,42101014100,42,81767.0,42,937,36,663,137,22,800,4,511,0,835,,,,102,,,,2094,70,1594,255,47,9,0,102,272,1025,937,192,745,88
2010,101,42101014200,42,101389.0,42,1813,64,140,150,57,1663,1,1203,0,394,,,,1419,,,,3570,149,296,404,130,1,1,168,2825,2063,1813,707,1106,250
2010,101,42101014300,42,103520.0,42,680,17,33,40,17,640,1,395,0,100,,,,580,,,,1439,53,66,103,40,1,1,26,1252,802,680,397,283,122
2010,101,42101014400,42,77659.0,42,1307,21,205,486,60,821,12,695,0,717,,,,590,,,,3105,63,589,1146,181,22,1,523,1726,1561,1307,603,704,254
2010,101,42101014500,42,89375.0,42,659,11,504,131,20,528,5,265,0,646,,,,13,,,,2464,106,1494,427,65,10,1,201,587,713,659,187,472,54
2010,101,42101014600,42,74063.0,42,1163,42,877,29,18,1134,6,660,0,961,,,,202,,,,4289,210,2237,138,99,16,1,58,1668,1192,1163,533,630,29
2010,101,42101014700,42,114718.0,42,958,51,477,50,43,908,1,668,0,607,,,,351,,,,3939,227,1695,186,132,2,1,69,1813,1170,958,179,779,212
2010,101,42101014800,42,75505.0,42,372,16,337,9,5,363,1,215,0,364,,,,8,,,,785,31,707,23,18,1,0,7,21,446,372,92,280,74
2010,101,42101014900,42,49928.0,42,1633,7,1555,36,30,1597,5,737,0,1614,,,,19,,,,3967,19,3775,114,75,15,0,25,58,2099,1633,755,878,466
2010,101,42101015101,42,71250.0,42,782,2,747,8,11,774,5,342,1,771,,,,11,,,,2038,6,1959,32,27,7,3,13,23,1097,782,317,465,315
2010,101,42101015102,42,30000.0,42,1794,5,1747,28,18,1766,10,773,0,1789,,,,5,,,,4269,14,4125,87,54,22,0,26,28,2274,1794,662,1132,480
2010,101,42101015200,42,44805.0,42,1936,8,1818,39,45,1897,6,555,1,1899,,,,37,,,,6133,20,5776,142,141,18,1,55,122,2372,1936,565,1371,436
2010,101,42101015300,42,45734.0,42,1434,68,808,46,25,1388,1,998,0,937,,,,497,,,,4962,266,2254,135,101,6,0,42,2293,1783,1434,303,1131,349
2010,101,42101015600,42,62806.0,42,607,8,136,378,23,229,12,250,1,524,,,,83,,,,1741,29,425,1109,64,28,1,658,536,705,607,251,356,98
2010,101,42101015700,42,38654.0,42,936,15,106,533,38,403,15,365,0,646,,,,290,,,,2641,33,325,1493,153,35,1,766,1328,1099,936,502,434,163
2010,101,42101015800,42,83125.0,42,2598,47,57,93,50,2505,2,1406,0,239,,,,2359,,,,5684,123,128,274,155,6,0,91,5181,2884,2598,1622,976,286
2010,101,42101016000,42,75219.0,42,2854,63,72,111,46,2743,6,1285,3,284,,,,2570,,,,7002,159,197,424,198,15,10,153,6270,3205,2854,1882,972,351
2010,101,42101016100,42,75357.0,42,1945,229,187,493,63,1452,15,811,0,924,,,,1021,,,,5590,776,672,1736,240,42,1,930,2929,2241,1945,945,1000,296
2010,101,42101016200,42,30781.0,42,769,7,169,580,46,189,9,268,1,729,,,,40,,,,2225,36,535,1664,130,30,1,929,564,897,769,258,511,128
2010,101,42101016300,42,35425.0,42,1031,69,162,774,53,257,5,299,0,968,,,,63,,,,3248,215,599,2434,156,18,0,1191,1069,1224,1031,472,559,193
2010,101,42101016400,42,89659.0,42,1485,7,576,918,88,567,14,453,0,1463,,,,22,,,,4564,23,1902,2709,255,45,0,1361,978,1739,1485,607,878,254
2010,101,42101016500,42,94044.0,42,989,3,902,60,16,929,4,345,0,970,,,,19,,,,2758,12,2522,205,41,9,0,96,78,1218,989,369,620,229
2010,101,42101016600,42,53409.0,42,586,13,474,21,17,565,2,305,0,520,,,,66,,,,1788,62,1352,109,50,4,0,58,262,729,586,175,411,143
2010,101,42101016701,42,65214.0,42,1171,3,1104,17,25,1154,8,471,0,1148,,,,23,,,,3055,7,2884,68,49,25,0,19,71,1558,1171,621,550,387
2010,101,42101016702,42,104093.0,42,1119,11,1014,30,25,1089,7,513,0,1074,,,,45,,,,2903,35,2588,85,49,13,1,37,180,1423,1119,481,638,304
2010,101,42101016800,42,65725.0,42,1515,3,1469,23,20,1492,6,607,0,1506,,,,9,,,,3935,15,3768,84,63,15,0,19,55,1932,1515,855,660,417
2010,101,42101016901,42,61143.0,42,1364,3,1316,20,15,1344,7,527,0,1353,,,,11,,,,3466,9,3344,71,44,16,1,20,32,1791,1364,782,582,427
2010,101,42101016902,42,55273.0,42,2191,2,2126,33,36,2158,6,863,0,2181,,,,10,,,,5524,2,5348,109,101,15,0,23,35,2814,2191,1190,1001,623
2010,101,42101017000,42,73571.0,42,1216,28,833,47,19,1169,1,606,1,916,,,,300,,,,2953,57,2240,129,34,7,1,47,567,1375,1216,404,812,159
2010,101,42101017100,42,63694.0,42,1570,1,1520,22,19,1548,4,527,1,1554,,,,16,,,,4047,2,3899,81,64,5,1,40,36,1809,1570,1029,541,239
2010,101,42101017201,42,86144.0,42,1289,7,1243,21,16,1268,5,505,0,1280,,,,9,,,,3194,10,3065,74,40,13,0,30,36,1536,1289,804,485,247
2010,101,42101017202,42,67750.0,42,1593,3,1540,27,22,1566,4,602,0,1584,,,,9,,,,4056,7,3896,112,51,11,0,32,59,1986,1593,1012,581,393
2010,101,42101017300,42,58589.0,42,1164,5,1102,24,21,1140,3,439,0,1145,,,,19,,,,3165,22,2917,129,55,12,1,55,103,1363,1164,634,530,199
2010,101,42101017400,42,20272.0,42,918,4,848,46,21,872,3,369,2,911,,,,7,,,,2419,12,2201,158,57,3,2,95,49,1115,918,434,484,197
2010,101,42101017500,42,31103.0,42,2274,8,748,1570,94,704,76,655,2,2234,,,,40,,,,7016,23,2214,5025,286,221,2,2544,1726,2603,2274,1149,1125,329
2010,101,42101017601,42,31277.0,42,1834,10,199,1664,109,170,56,581,2,1781,,,,53,,,,5562,34,652,5074,369,167,7,2108,2225,2097,1834,782,1052,263
2010,101,42101017602,42,33681.0,42,1199,11,200,962,71,237,31,348,1,1121,,,,78,,,,3914,46,708,3199,233,88,1,1417,1421,1371,1199,562,637,172
2010,101,42101017701,42,43462.0,42,1088,41,341,595,35,493,106,254,2,950,,,,138,,,,3705,122,1168,2177,157,335,6,1047,870,1352,1088,408,680,264
2010,101,42101017702,42,32554.0,42,1544,42,326,1028,81,516,90,408,1,1358,,,,186,,,,5076,136,1077,3535,307,292,2,1785,1477,1824,1544,680,864,280
2010,101,42101017800,42,33779.0,42,2059,57,554,918,88,1141,13,641,2,1509,,,,550,,,,6704,204,1936,3370,373,42,12,2023,2114,2518,2059,819,1240,459
2010,101,42101017900,42,55764.0,42,2095,20,433,553,66,1542,13,669,0,1001,,,,1094,,,,6313,63,1460,2196,309,52,0,1269,3160,2415,2095,1132,963,320
2010,101,42101018001,42,30842.0,42,1093,17,22,53,9,1040,3,480,1,98,,,,995,,,,2586,26,63,176,49,6,1,42,2399,1202,1093,650,443,109
2010,101,42101018002,42,44364.0,42,2390,13,15,50,19,2340,3,1027,0,97,,,,2293,,,,5451,30,33,187,59,5,0,41,5283,2630,2390,1683,707,240
2010,101,42101018300,42,44524.0,42,1664,5,7,16,9,1648,1,558,0,38,,,,1626,,,,4313,17,24,91,62,7,0,9,4194,1768,1664,1405,259,104
2010,101,42101018400,42,33951.0,42,869,3,2,18,15,851,2,287,0,38,,,,831,,,,2260,16,9,84,50,6,1,26,2152,921,869,646,223,52
2010,101,42101018800,42,23145.0,42,2483,26,669,998,91,1485,19,719,1,1661,,,,822,,,,8322,99,2453,3865,433,61,7,2373,2896,2849,2483,1181,1302,366
2010,101,42101019000,42,26681.0,42,2403,99,581,1196,100,1207,32,619,2,1832,,,,571,,,,7543,348,1859,4209,377,113,13,2382,2451,2568,2403,1398,1005,165
2010,101,42101019100,42,25347.0,42,2634,226,361,1360,110,1274,12,686,0,1908,,,,726,,,,7937,852,1106,4602,423,35,1,2517,3003,2777,2634,1986,648,143
2010,101,42101019200,42,24312.0,42,2333,69,592,1377,99,956,113,551,2,1963,,,,370,,,,7972,264,2173,5070,373,367,10,2438,2347,2707,2333,1113,1220,374
2010,101,42101019501,42,20326.0,42,1584,13,232,1324,82,260,29,456,1,1499,,,,85,,,,4927,40,830,4100,271,89,2,1734,1961,1741,1584,663,921,157
2010,101,42101019502,42,34391.0,42,1132,11,158,933,51,199,37,283,1,1053,,,,79,,,,3675,40,557,3096,175,117,3,1347,1436,1291,1132,555,577,159
2010,101,42101019700,42,34885.0,42,2127,27,755,1314,121,813,21,501,1,2048,,,,79,,,,7001,102,2478,4477,399,79,1,2514,1428,2316,2127,1214,913,189
2010,101,42101019800,42,54063.0,42,1925,50,752,1127,79,798,16,483,4,1870,,,,55,,,,6195,167,2270,3868,325,57,13,2173,1190,2163,1925,1046,879,238
2010,101,42101019900,42,34728.0,42,1413,5,602,786,42,627,20,418,0,1367,,,,46,,,,4419,13,1809,2622,160,48,0,1623,766,1661,1413,704,709,248
2010,101,42101020000,42,57449.0,42,589,51,452,25,12,564,3,337,0,535,,,,54,,,,1265,79,1020,70,20,8,0,31,107,787,589,169,420,198
2010,101,42101020101,42,37070.0,42,1562,12,1453,51,30,1511,6,798,0,1529,,,,33,,,,3547,36,3289,139,80,9,0,41,92,2055,1562,516,1046,493
2010,101,42101020102,42,37205.0,42,1317,4,1234,43,31,1274,5,584,0,1297,,,,20,,,,3353,14,3130,145,80,12,0,36,81,1678,1317,693,624,361
2010,101,42101020200,42,22344.0,42,1961,6,1876,34,35,1927,9,879,0,1941,,,,20,,,,5189,13,4848,122,117,19,2,31,159,2550,1961,945,1016,589
2010,101,42101020300,42,34676.0,42,1059,8,955,45,24,1014,6,448,1,1023,,,,36,,,,2769,24,2429,181,72,18,1,85,140,1340,1059,516,543,281
2010,101,42101020400,42,47110.0,42,1130,8,1060,37,17,1093,4,398,0,1114,,,,16,,,,3050,16,2829,122,66,8,4,46,81,1392,1130,654,476,262
2010,101,42101020500,42,43000.0,42,1273,71,1118,14,18,1259,6,627,0,1220,,,,53,,,,2819,100,2549,50,43,11,0,12,104,1416,1273,614,659,143
2010,101,42101020600,42,,42,875,85,322,30,12,845,1,524,2,443,,,,432,,,,1819,142,610,84,44,2,3,16,1002,990,875,266,609,115
2010,101,42101020700,42,53200.0,42,2505,69,329,62,37,2443,3,1369,0,493,,,,2012,,,,5841,197,776,195,149,6,0,39,4674,2684,2505,1552,953,179
2010,101,42101020800,42,48323.0,42,1146,99,373,55,34,1091,6,897,0,558,,,,588,,,,1971,161,593,104,54,7,0,25,1131,1403,1146,356,790,257
2010,101,42101020900,42,41447.0,42,1368,36,47,28,22,1340,2,840,0,136,,,,1232,,,,2910,88,128,90,82,4,0,12,2596,1463,1368,688,680,95
2010,101,42101021000,42,40496.0,42,2338,33,66,43,19,2295,2,1521,1,160,,,,2178,,,,4917,83,149,116,71,9,3,24,4578,2528,2338,1226,1112,190
2010,101,42101021100,42,39715.0,42,1114,30,98,20,13,1094,1,552,0,158,,,,956,,,,2327,70,181,65,52,3,0,10,2011,1218,1114,740,374,104
2010,101,42101021200,42,30833.0,42,1060,37,78,29,12,1031,0,580,0,154,,,,906,,,,2245,80,153,73,43,1,0,22,1946,1134,1060,683,377,74
2010,101,42101021300,42,23214.0,42,1551,22,60,41,16,1510,1,869,0,132,,,,1419,,,,3551,40,201,134,64,2,0,49,3195,1651,1551,875,676,100
2010,101,42101021400,42,32125.0,42,1809,33,94,51,34,1758,2,1269,1,208,,,,1601,,,,3880,64,258,109,77,6,3,22,3450,2001,1809,800,1009,192
2010,101,42101021500,42,25833.0,42,1765,38,74,40,22,1725,2,1030,0,174,,,,1591,,,,3857,81,160,97,72,3,0,22,3519,1924,1765,1017,748,159
2010,101,42101021600,42,25158.0,42,896,34,94,24,17,872,2,496,0,166,,,,730,,,,1826,68,166,59,34,5,0,14,1539,1016,896,389,507,120
2010,101,42101021700,42,23815.0,42,2449,66,203,62,34,2387,4,898,0,358,,,,2091,,,,5772,203,474,190,119,17,1,47,4911,2571,2449,1985,464,122
2010,101,42101021800,42,18125.0,42,2173,106,275,72,34,2101,2,1359,0,481,,,,1692,,,,4259,226,564,181,104,6,2,46,3311,2323,2173,571,1602,150
2010,101,42101021900,42,28819.0,42,689,15,50,14,6,675,1,327,0,84,,,,605,,,,1432,25,80,36,17,2,0,8,1300,721,689,610,79,32
2010,101,42101022000,42,32697.0,42,718,24,65,6,6,712,0,332,1,102,,,,616,,,,1681,57,152,31,29,0,2,4,1437,797,718,485,233,79
2010,101,42101023100,42,25444.0,42,526,9,20,16,6,510,0,185,0,50,,,,476,,,,1262,24,41,39,27,1,0,8,1161,562,526,333,193,36
2010,101,42101023500,42,29698.0,42,540,4,211,6,8,534,5,241,0,234,,,,306,,,,1161,19,431,26,30,7,0,6,668,577,540,368,172,37
2010,101,42101023600,42,25662.0,42,1095,15,389,28,24,1067,3,466,0,452,,,,643,,,,2619,38,984,71,81,5,0,19,1492,1165,1095,700,395,70
2010,101,42101023700,42,22058.0,42,2162,13,1353,63,62,2099,6,1225,1,1476,,,,686,,,,4566,39,2929,152,175,14,1,49,1359,2347,2162,889,1273,185
2010,101,42101023800,42,30536.0,42,2077,25,1366,52,43,2025,15,1256,0,1478,,,,599,,,,4391,46,2825,153,167,23,0,37,1293,2398,2077,772,1305,321
2010,101,42101023900,42,38849.0,42,1143,40,830,29,27,1114,6,848,1,919,,,,224,,,,1777,73,1299,63,44,9,1,10,341,1321,1143,130,1013,178
2010,101,42101024000,42,41343.0,42,1851,80,1180,49,48,1802,5,1090,1,1347,,,,504,,,,3822,136,2482,130,133,13,1,37,1020,2104,1851,559,1292,253
2010,101,42101024100,42,30797.0,42,733,7,606,14,12,719,3,569,0,637,,,,96,,,,1433,16,1154,43,30,9,0,13,211,824,733,84,649,91
2010,101,42101024200,42,26083.0,42,1710,6,1389,40,55,1670,10,775,1,1482,,,,228,,,,4236,18,3538,124,152,15,3,52,458,2019,1710,732,978,309
2010,101,42101024300,42,31763.0,42,1723,18,1435,33,45,1690,5,735,0,1518,,,,205,,,,3913,33,3314,110,122,10,0,37,397,1929,1723,773,950,206
2010,101,42101024400,42,37500.0,42,1151,11,1043,22,23,1129,5,418,0,1089,,,,62,,,,3129,24,2840,77,78,14,2,23,148,1350,1151,614,537,199
2010,101,42101024500,42,25846.0,42,1531,2,1411,35,34,1496,5,612,1,1469,,,,62,,,,4035,8,3756,113,90,12,1,40,128,1839,1531,629,902,308
2010,101,42101024600,42,28000.0,42,1151,4,1012,29,21,1122,7,532,1,1064,,,,87,,,,2956,11,2607,101,54,13,2,55,214,1304,1151,339,812,153
2010,101,42101024700,42,25911.0,42,1603,8,1449,26,32,1577,13,591,0,1515,,,,88,,,,4423,22,3941,134,101,20,1,46,292,1932,1603,856,747,329
2010,101,42101024800,42,28059.0,42,700,2,663,10,14,690,4,206,0,687,,,,13,,,,1889,7,1800,33,32,12,0,10,28,786,700,496,204,86
2010,101,42101024900,42,37449.0,42,1194,1,1143,20,21,1174,3,368,0,1179,,,,15,,,,3311,8,3154,84,61,8,0,31,49,1369,1194,769,425,175
2010,101,42101025200,42,29472.0,42,2783,14,2532,79,66,2704,13,1205,0,2661,,,,122,,,,7118,33,6396,270,199,31,2,76,381,3155,2783,1433,1350,372
2010,101,42101025300,42,33880.0,42,1648,10,1454,36,40,1612,9,680,1,1536,,,,112,,,,4002,25,3557,132,108,24,1,31,256,1944,1648,1047,601,296
2010,101,42101025400,42,24808.0,42,1816,3,1597,36,44,1780,3,768,2,1670,,,,146,,,,3920,12,3414,106,109,9,3,28,345,1999,1816,1215,601,183
2010,101,42101025500,42,20543.0,42,1079,11,682,24,34,1055,6,456,0,746,,,,333,,,,2571,41,1585,110,114,12,0,24,795,1148,1079,745,334,69
2010,101,42101025600,42,10584.0,42,1149,18,526,30,33,1119,5,430,0,599,,,,550,,,,2742,53,1194,103,121,7,0,37,1330,1191,1149,785,364,42
2010,101,42101025700,42,20635.0,42,1885,80,675,73,35,1812,7,1136,0,858,,,,1027,,,,3463,161,1119,158,103,9,0,30,2041,2052,1885,463,1422,167
2010,101,42101025800,42,15119.0,42,761,4,708,9,12,752,3,305,0,730,,,,31,,,,1681,15,1558,33,40,5,0,5,58,788,761,595,166,27
2010,101,42101025900,42,22264.0,42,2060,3,1962,30,35,2030,6,764,2,2023,,,,37,,,,4755,8,4525,103,92,11,5,41,73,2151,2060,1415,645,91
2010,101,42101026000,42,23264.0,42,1197,2,1147,17,17,1180,4,438,0,1174,,,,23,,,,2788,8,2650,53,56,10,0,13,51,1252,1197,941,256,55
2010,101,42101026100,42,19433.0,42,1398,1,1340,16,30,1382,1,590,1,1377,,,,21,,,,2995,4,2859,39,63,3,1,13,52,1469,1398,972,426,71
2010,101,42101026200,42,17384.0,42,1758,3,1681,22,32,1736,7,618,0,1732,,,,26,,,,4065,8,3867,79,104,19,0,20,47,1833,1758,1411,347,75
2010,101,42101026301,42,20777.0,42,1555,1,1486,23,25,1532,4,510,1,1520,,,,35,,,,3840,8,3670,61,77,12,1,8,64,1623,1555,1269,286,68
2010,101,42101026302,42,37361.0,42,2082,6,1998,27,40,2055,4,669,0,2055,,,,27,,,,5480,24,5206,109,130,10,0,35,75,2179,2082,1599,483,97
2010,101,42101026400,42,50769.0,42,2143,2,2058,24,45,2119,11,735,0,2121,,,,22,,,,5241,11,5034,62,110,20,2,9,55,2271,2143,1758,385,128
2010,101,42101026500,42,39474.0,42,1687,1,1625,24,26,1663,7,537,0,1665,,,,22,,,,4340,3,4172,88,79,21,0,16,49,1865,1687,1253,434,178
2010,101,42101026600,42,25764.0,42,2492,3,2428,27,30,2465,4,759,0,2476,,,,16,,,,6667,9,6466,108,94,18,0,31,49,2648,2492,2039,453,156
2010,101,42101026700,42,16622.0,42,2549,8,2462,33,38,2516,10,835,0,2533,,,,16,,,,6565,24,6292,160,124,20,0,44,61,2788,2549,1825,724,239
2010,101,42101026800,42,27321.0,42,1873,35,1670,53,46,1820,6,831,1,1789,,,,84,,,,4647,102,4066,149,127,15,2,57,278,2141,1873,679,1194,268
2010,101,42101026900,42,34432.0,42,688,24,435,41,27,647,6,242,0,527,,,,161,,,,2199,60,1481,173,78,10,2,105,463,744,688,436,252,56
2010,101,42101027000,42,16445.0,42,922,37,723,29,20,893,5,360,0,809,,,,113,,,,2326,131,1779,117,56,15,0,51,294,981,922,520,402,59
2010,101,42101027100,42,19770.0,42,895,157,555,66,17,829,3,269,0,792,,,,103,,,,2453,515,1497,201,59,9,0,107,266,926,895,650,245,31
2010,101,42101027200,42,20292.0,42,1803,104,1424,94,33,1709,10,670,1,1645,,,,158,,,,4278,286,3372,276,105,17,3,121,374,1896,1803,1107,696,93
2010,101,42101027300,42,14924.0,42,2052,374,1131,298,55,1754,3,555,2,1828,,,,224,,,,6069,1404,3126,1084,176,9,2,651,701,2158,2052,1368,684,106
2010,101,42101027401,42,18411.0,42,1140,286,579,152,34,988,3,314,1,1026,,,,114,,,,3457,964,1689,539,126,7,6,241,424,1237,1140,692,448,97
2010,101,42101027402,42,20926.0,42,2246,271,1351,345,63,1901,13,562,2,1994,,,,252,,,,6800,1052,4047,1172,219,33,9,583,857,2393,2246,1505,741,147
2010,101,42101027500,42,18489.0,42,1559,148,1054,150,37,1409,5,440,0,1361,,,,198,,,,4489,545,3022,533,110,24,0,259,529,1666,1559,1149,410,107
2010,101,42101027600,42,24290.0,42,1520,26,1366,34,42,1486,6,645,1,1458,,,,62,,,,3600,58,3243,121,110,20,1,32,136,1805,1520,787,733,285
2010,101,42101027700,42,40435.0,42,2078,142,1858,31,29,2047,5,956,0,2048,,,,30,,,,4788,187,4424,104,80,15,0,35,47,2311,2078,1049,1029,233
2010,101,42101027800,42,31716.0,42,1931,13,1850,43,30,1888,8,844,1,1915,,,,16,,,,4481,44,4258,141,86,19,1,29,44,2203,1931,1043,888,272
2010,101,42101027901,42,52083.0,42,1430,5,1358,23,31,1407,7,472,1,1411,,,,19,,,,3827,10,3637,84,89,14,2,30,45,1653,1430,883,547,223
2010,101,42101027902,42,50417.0,42,895,4,766,22,31,873,1,393,0,814,,,,81,,,,3873,55,1949,161,107,5,1,44,1712,1093,895,505,390,198
2010,101,42101028000,42,43396.0,42,1604,7,1535,30,28,1574,6,601,0,1588,,,,16,,,,4272,27,4063,127,80,17,1,46,38,1860,1604,896,708,256
2010,101,42101028100,42,36467.0,42,1316,24,1192,43,30,1273,5,451,0,1277,,,,39,,,,3589,62,3231,140,97,13,1,55,130,1476,1316,877,439,160
2010,101,42101028200,42,43750.0,42,1939,146,1594,86,46,1853,8,851,0,1853,,,,86,,,,4899,305,4115,278,145,19,1,104,210,2193,1939,981,958,254
2010,101,42101028300,42,34837.0,42,2190,145,1883,83,40,2107,6,756,1,2143,,,,47,,,,6173,490,5159,345,133,16,3,206,166,2771,2190,1084,1106,581
2010,101,42101028400,42,14939.0,42,1283,15,992,242,35,1041,13,307,0,1249,,,,34,,,,4085,61,3104,859,143,36,0,446,295,1424,1283,757,526,141
2010,101,42101028500,42,22036.0,42,806,93,429,262,19,544,2,258,1,785,,,,21,,,,2375,319,1124,884,100,7,1,510,314,887,806,382,424,81
2010,101,42101028600,42,41528.0,42,2182,200,1192,685,72,1497,13,521,2,2059,,,,123,,,,7124,728,3782,2419,232,41,6,1359,976,2375,2182,1266,916,193
2010,101,42101028700,42,52182.0,42,791,11,239,517,46,274,11,194,1,751,,,,40,,,,2507,31,748,1698,147,38,2,920,621,878,791,409,382,87
2010,101,42101028800,42,29458.0,42,1309,127,334,718,48,591,14,337,0,1152,,,,157,,,,4245,455,1019,2441,200,40,0,1433,1098,1442,1309,715,594,133
2010,101,42101028901,42,18607.0,42,1166,81,330,625,56,541,7,274,0,1010,,,,156,,,,3857,278,1074,2247,178,26,3,1228,1070,1281,1166,703,463,115
2010,101,42101028902,42,48647.0,42,1843,155,588,900,74,943,13,380,5,1628,,,,215,,,,6315,579,1943,3330,293,45,21,2021,1413,1975,1843,1094,749,132
2010,101,42101029000,42,68641.0,42,2003,303,939,509,76,1494,6,526,1,1764,,,,239,,,,6160,1080,2802,1785,252,26,6,1023,971,2150,2003,1265,738,147
2010,101,42101029100,42,72083.0,42,1526,331,630,305,56,1221,10,382,1,1299,,,,227,,,,4685,1212,1849,1077,192,23,7,504,898,1619,1526,736,790,93
2010,101,42101029200,42,58295.0,42,1313,104,507,428,47,885,10,301,1,1027,,,,286,,,,4080,333,1569,1507,193,37,7,791,1150,1429,1313,865,448,116
2010,101,42101029300,42,98452.0,42,997,19,374,251,39,746,8,361,0,643,,,,354,,,,2891,52,1243,843,148,44,0,376,1028,1204,997,413,584,207
2010,101,42101029400,42,76186.0,42,1071,12,480,290,36,781,5,381,0,785,,,,286,,,,3141,38,1456,1005,141,13,0,576,917,1283,1071,479,592,212
2010,101,42101029800,42,25582.0,42,1772,41,589,334,67,1438,6,616,2,970,,,,802,,,,4715,127,1754,1124,230,18,6,553,2027,1934,1772,963,809,162
2010,101,42101029900,42,26500.0,42,1544,22,755,365,48,1179,9,435,0,1141,,,,403,,,,4700,71,2483,1332,192,32,1,691,1230,1737,1544,652,892,193
2010,101,42101030000,42,15542.0,42,2616,50,1555,407,76,2209,11,985,1,2049,,,,567,,,,7478,147,4613,1485,320,24,4,852,1518,3007,2616,1078,1538,391
2010,101,42101030100,42,31684.0,42,2153,32,1127,355,69,1798,18,800,0,1519,,,,634,,,,5869,98,3187,1188,272,48,2,519,1743,2489,2153,980,1173,336
2010,101,42101030200,42,19808.0,42,2491,55,1196,517,112,1974,13,743,4,1781,,,,710,,,,7345,173,3712,1861,430,41,16,812,2161,2652,2491,1527,964,161
2010,101,42101030501,42,68529.0,42,1772,96,935,328,59,1444,9,482,1,1376,,,,396,,,,5231,304,2835,1168,228,25,5,616,1218,1918,1772,1090,682,146
2010,101,42101030502,42,57024.0,42,1954,115,1000,297,50,1657,8,516,0,1414,,,,540,,,,5839,412,3172,1070,190,38,0,573,1454,2077,1954,1473,481,123
2010,101,42101030600,42,34091.0,42,2686,117,733,404,65,2282,10,1085,1,1273,,,,1413,,,,7115,443,2063,1307,240,15,3,689,3662,2872,2686,1514,1172,186
2010,101,42101030700,42,14286.0,42,1333,69,297,167,46,1166,8,572,1,556,,,,777,,,,3235,216,724,503,150,16,5,201,1923,1518,1333,515,818,185
2010,101,42101030800,42,22526.0,42,1717,166,277,156,32,1561,3,457,2,630,,,,1087,,,,4874,647,920,586,144,5,7,297,2854,1798,1717,1329,388,81
2010,101,42101030900,42,8980.0,42,1345,172,440,255,39,1090,3,355,2,902,,,,443,,,,3991,629,1428,850,116,20,7,444,1347,1443,1345,786,559,98
2010,101,42101031000,42,11450.0,42,2174,358,473,288,45,1886,7,521,7,1168,,,,1006,,,,6755,1416,1602,1065,182,35,19,541,2960,2295,2174,1510,664,121
2010,101,42101031101,42,21277.0,42,1574,156,596,289,49,1285,11,399,5,1094,,,,480,,,,4898,580,2061,1040,201,51,10,677,1318,1693,1574,876,698,119
2010,101,42101031102,42,17146.0,42,1419,97,631,287,45,1132,5,335,0,1036,,,,383,,,,4465,346,2096,1035,150,29,2,674,1168,1505,1419,1002,417,86
2010,101,42101031200,42,12316.0,42,1592,159,693,282,53,1310,8,475,2,1163,,,,429,,,,4673,526,2149,990,181,20,8,477,1312,1698,1592,864,728,106
2010,101,42101031300,42,15394.0,42,2268,440,555,390,78,1878,17,579,3,1472,,,,796,,,,6945,1597,1859,1355,314,59,14,748,2354,2384,2268,1240,1028,116
2010,101,42101031401,42,10375.0,42,2118,409,434,376,65,1742,8,504,7,1300,,,,818,,,,6664,1472,1473,1401,261,27,22,813,2596,2222,2118,1196,922,104
2010,101,42101031402,42,16875.0,42,1834,419,260,261,47,1573,5,452,2,968,,,,866,,,,5595,1603,891,962,198,12,10,519,2362,1908,1834,1282,552,74
2010,101,42101031501,42,26445.0,42,2294,106,68,114,28,2180,4,708,0,307,,,,1987,,,,6217,372,235,489,144,14,0,183,5269,2419,2294,1690,604,125
2010,101,42101031502,42,44222.0,42,1538,90,115,91,17,1447,3,506,0,318,,,,1220,,,,4018,317,301,331,89,5,0,178,3128,1608,1538,1022,516,70
2010,101,42101031600,42,42994.0,42,2170,122,165,150,29,2020,3,627,0,458,,,,1712,,,,6045,435,569,598,149,9,2,277,4604,2270,2170,1711,459,100
2010,101,42101031700,42,24091.0,42,2240,147,424,333,65,1907,5,690,1,942,,,,1298,,,,6093,497,1364,1119,247,21,5,636,3323,2365,2240,1532,708,125
2010,101,42101031800,42,17314.0,42,1438,72,511,299,38,1139,6,471,1,900,,,,538,,,,4017,263,1561,1033,177,14,1,580,1421,1516,1438,1027,411,78
2010,101,42101031900,42,12232.0,42,1716,35,350,277,38,1439,7,492,1,668,,,,1048,,,,4971,121,1141,1005,217,19,2,508,2963,1862,1716,1101,615,146
2010,101,42101032000,42,13364.0,42,2490,56,343,294,44,2196,6,846,1,708,,,,1782,,,,6599,188,1062,1079,201,26,3,510,4609,2656,2490,1837,653,166
2010,101,42101032100,42,13649.0,42,1447,27,285,222,42,1225,13,526,1,558,,,,889,,,,3903,91,841,763,192,34,1,416,2328,1584,1447,813,634,137
2010,101,42101032300,42,13750.0,42,1451,32,333,165,29,1286,8,565,1,542,,,,909,,,,3835,100,951,647,128,29,1,268,2358,1574,1451,837,614,123
2010,101,42101032500,42,21987.0,42,2216,42,294,227,52,1989,6,876,1,599,,,,1617,,,,5766,118,921,820,252,14,1,414,4046,2434,2216,1303,913,218
2010,101,42101032600,42,17076.0,42,2534,65,275,223,38,2311,4,841,1,590,,,,1944,,,,6942,205,912,860,220,13,6,340,5246,2697,2534,1762,772,163
2010,101,42101032900,42,29375.0,42,1725,39,334,175,40,1550,5,769,0,576,,,,1149,,,,4089,146,797,572,171,14,0,256,2705,1831,1725,950,775,106
2010,101,42101033000,42,24313.0,42,2708,73,361,267,49,2441,8,833,1,728,,,,1980,,,,7645,231,1250,1108,285,18,10,467,5384,2889,2708,1880,828,181
2010,101,42101033101,42,23427.0,42,1870,39,49,82,12,1788,2,602,0,180,,,,1690,,,,4913,149,165,291,72,5,0,117,4405,1921,1870,1468,402,51
2010,101,42101033102,42,22413.0,42,1726,22,100,82,16,1644,5,703,1,220,,,,1506,,,,4145,78,235,277,86,13,1,115,3617,1833,1726,1081,645,107
2010,101,42101033200,42,25551.0,42,1000,50,34,40,5,960,0,272,0,125,,,,875,,,,2741,194,121,141,34,0,0,46,2346,1034,1000,841,159,34
2010,101,42101033300,42,19816.0,42,1684,48,183,93,22,1591,2,774,1,348,,,,1336,,,,4244,139,404,245,76,5,1,140,3479,1772,1684,1046,638,88
2010,101,42101033400,42,19967.0,42,1921,198,233,175,39,1746,4,754,0,643,,,,1278,,,,4734,694,550,495,140,12,2,195,3141,2025,1921,1090,831,104
2010,101,42101033500,42,20036.0,42,1388,150,121,123,26,1265,8,481,1,436,,,,952,,,,3680,588,350,409,119,27,1,234,2361,1444,1388,939,449,56
2010,101,42101033600,42,19750.0,42,2848,153,253,216,35,2632,5,1133,1,677,,,,2171,,,,6866,555,585,679,153,22,2,378,5171,2999,2848,1385,1463,151
2010,101,42101033701,42,14768.0,42,2291,103,117,161,39,2130,3,1003,0,410,,,,1881,,,,5128,364,287,502,145,9,0,171,4152,2430,2291,933,1358,139
2010,101,42101033702,42,12039.0,42,1992,178,131,127,19,1865,1,646,0,459,,,,1533,,,,5175,641,430,407,96,6,0,138,3864,2063,1992,1513,479,71
2010,101,42101033800,42,17535.0,42,2533,91,217,151,55,2382,2,1024,0,520,,,,2013,,,,6040,287,538,508,178,8,0,241,4788,2651,2533,1491,1042,118
2010,101,42101033900,42,19796.0,42,1243,41,104,75,14,1168,4,509,1,239,,,,1004,,,,2924,118,222,273,76,7,1,121,2379,1305,1243,797,446,62
2010,101,42101034000,42,16036.0,42,1072,54,34,49,8,1023,2,311,0,143,,,,929,,,,2872,210,108,202,52,6,0,85,2411,1106,1072,950,122,34
2010,101,42101034100,42,20586.0,42,2498,86,135,94,29,2404,5,1086,0,346,,,,2152,,,,5577,192,271,272,100,9,2,75,4928,2622,2498,1409,1089,124
2010,101,42101034200,42,23516.0,42,1580,45,108,39,10,1541,1,703,0,196,,,,1384,,,,3399,144,287,117,37,3,0,30,2898,1665,1580,744,836,85
2010,101,42101034400,42,33611.0,42,2733,239,70,85,30,2648,7,642,0,427,,,,2306,,,,7662,948,220,344,94,19,1,107,6273,2807,2733,2457,276,74
2010,101,42101034501,42,34966.0,42,1827,162,140,76,16,1751,1,1016,2,394,,,,1433,,,,3370,502,306,184,52,5,2,74,2429,1932,1827,274,1553,105
2010,101,42101034502,42,44742.0,42,2427,159,412,143,48,2284,2,1075,0,745,,,,1682,,,,5285,489,868,405,203,9,0,143,3573,2554,2427,1033,1394,127
2010,101,42101034600,42,42639.0,42,1215,74,302,106,21,1109,0,698,1,490,,,,725,,,,2250,240,576,251,48,5,1,87,1293,1303,1215,309,906,88
2010,101,42101034701,42,23237.0,42,2465,217,276,181,52,2284,9,792,2,725,,,,1740,,,,6399,833,703,547,200,25,2,188,4448,2555,2465,1871,594,90
2010,101,42101034702,42,27955.0,42,1438,50,111,75,15,1363,3,408,0,241,,,,1197,,,,3807,176,278,246,61,11,0,73,3208,1475,1438,1217,221,37
2010,101,42101034801,42,29583.0,42,1942,19,89,57,14,1885,4,781,2,179,,,,1763,,,,4299,62,223,174,74,9,3,48,3880,1996,1942,1060,882,54
2010,101,42101034802,42,21816.0,42,2178,45,533,157,37,2021,7,813,1,757,,,,1421,,,,5373,134,1229,471,154,13,4,160,3679,2281,2178,1181,997,103
2010,101,42101034803,42,13400.0,42,1731,37,102,69,12,1662,4,523,0,222,,,,1509,,,,4390,117,282,230,61,7,0,85,3838,1794,1731,1366,365,63
2010,101,42101034900,42,17679.0,42,2159,78,396,189,31,1970,11,793,1,689,,,,1470,,,,5543,300,1042,658,174,30,2,214,3781,2732,2159,1294,865,573
2010,101,42101035100,42,21219.0,42,2344,25,85,46,15,2298,3,1386,1,171,,,,2173,,,,4086,67,166,116,32,7,1,44,3769,2462,2344,1500,844,118
2010,101,42101035200,42,21273.0,42,1758,73,22,43,14,1715,2,590,0,153,,,,1605,,,,4482,258,90,169,52,5,1,42,4034,1828,1758,1315,443,70
2010,101,42101035301,42,19697.0,42,1995,55,90,61,25,1934,1,602,1,230,,,,1765,,,,5300,191,216,213,106,9,1,62,4715,2061,1995,1597,398,66
2010,101,42101035302,42,28646.0,42,1919,50,127,77,20,1842,2,791,0,270,,,,1649,,,,4462,161,252,206,103,4,0,89,3853,2013,1919,1207,712,94
2010,101,42101035500,42,25034.0,42,2976,235,137,131,43,2845,10,982,0,545,,,,2431,,,,7282,883,331,430,156,17,5,181,5709,3079,2976,1953,1023,103
2010,101,42101035601,42,31149.0,42,2432,122,24,60,14,2372,2,1021,1,221,,,,2211,,,,5439,454,51,203,66,10,1,63,4794,2525,2432,1644,788,93
2010,101,42101035602,42,21068.0,42,1279,194,72,49,21,1230,1,292,1,336,,,,943,,,,3617,733,198,165,62,10,4,58,2552,1310,1279,1001,278,31
2010,101,42101035701,42,26071.0,42,1932,346,180,90,67,1842,9,682,0,677,,,,1255,,,,4745,1222,439,255,216,25,0,110,2733,2007,1932,612,1320,75
2010,101,42101035702,42,30740.0,42,1752,102,43,53,38,1699,2,549,2,238,,,,1514,,,,4405,373,132,191,121,13,4,70,3692,1821,1752,617,1135,69
2010,101,42101035800,42,20286.0,42,2290,157,115,84,32,2206,4,622,0,387,,,,1903,,,,5948,546,313,284,147,16,2,90,4834,2347,2290,1890,400,57
2010,101,42101035900,42,48875.0,42,2210,170,84,79,34,2131,2,779,0,362,,,,1848,,,,5309,601,204,242,133,12,0,88,4271,2242,2210,1520,690,32
2010,101,42101036000,42,66373.0,42,1157,177,109,41,27,1116,2,445,0,351,,,,806,,,,3201,666,295,138,97,7,1,64,2071,1188,1157,705,452,31
2010,101,42101036100,42,36218.0,42,1530,24,289,103,23,1427,0,445,0,424,,,,1106,,,,4083,70,679,362,104,0,1,111,3118,1628,1530,1002,528,98
2010,101,42101036201,42,61625.0,42,1973,44,93,106,26,1867,7,703,0,262,,,,1711,,,,4744,120,193,283,119,21,0,81,4210,2149,1973,1375,598,176
2010,101,42101036202,42,67132.0,42,2349,54,177,72,25,2277,0,675,1,323,,,,2026,,,,6138,180,380,253,116,3,5,75,5379,2409,2349,1991,358,60
2010,101,42101036203,42,66964.0,42,1880,41,52,99,17,1781,3,466,0,203,,,,1677,,,,5129,136,140,297,66,7,0,78,4702,1923,1880,1691,189,43
2010,101,42101036301,42,62547.0,42,1341,80,55,55,22,1286,1,347,0,210,,,,1131,,,,3695,302,146,246,109,3,0,106,3029,1382,1341,1139,202,41
2010,101,42101036302,42,58386.0,42,1265,27,205,97,22,1168,3,323,0,344,,,,921,,,,3543,93,554,371,123,9,1,167,2596,1346,1265,920,345,81
2010,101,42101036303,42,59167.0,42,2470,38,45,50,10,2420,3,603,0,143,,,,2327,,,,6726,126,120,220,73,4,1,66,6336,2519,2470,2289,181,49
2010,101,42101036400,42,69855.0,42,66,3,4,3,2,63,0,31,0,11,,,,55,,,,703,10,152,17,4,0,0,3,534,417,66,47,19,351
2010,101,42101036501,42,49245.0,42,2345,67,215,101,31,2244,2,979,0,400,,,,1945,,,,5562,228,453,299,92,5,0,84,4700,2458,2345,1225,1120,113
2010,101,42101036502,42,65286.0,42,1490,37,29,41,16,1449,0,365,0,125,,,,1365,,,,4077,114,84,165,52,5,0,69,3753,1518,1490,1327,163,28
2010,101,42101036600,42,52663.0,42,991,95,64,27,19,964,6,653,0,208,,,,783,,,,1643,171,104,64,31,7,0,24,1306,1350,991,560,431,359
2010,101,42101036700,42,77644.0,42,1378,49,179,79,29,1299,3,927,1,337,,,,1041,,,,2542,104,409,181,58,6,2,88,1875,1529,1378,607,771,151
2010,101,42101036900,42,73864.0,42,680,210,30,30,22,650,0,545,0,285,,,,395,,,,6966,2255,776,383,288,4,7,59,3577,708,680,2,678,28
2010,101,42101037200,42,106927.0,42,1773,187,90,55,15,1718,1,666,0,343,,,,1430,,,,4244,653,239,223,76,2,0,134,3140,1882,1773,1442,331,109
2010,101,42101037300,42,76548.0,42,2362,101,304,42,23,2320,4,1036,1,473,,,,1889,,,,5137,263,534,113,46,7,1,54,4232,2625,2362,1411,951,263
2010,101,42101037500,42,77356.0,42,1479,72,603,41,36,1438,6,723,1,749,,,,730,,,,3771,184,1460,158,118,17,1,48,1943,1557,1479,760,719,78
2010,101,42101037600,42,44077.0,42,1106,218,253,71,24,1035,1,753,0,564,,,,542,,,,2986,610,1046,257,69,15,1,112,1133,1220,1106,312,794,114
2010,101,42101037700,42,33175.0,42,1351,53,828,269,35,1082,10,549,0,1133,,,,218,,,,5635,218,2786,900,153,22,0,439,2017,1506,1351,374,977,155
2010,101,42101037800,42,29346.0,42,1053,16,30,47,11,1006,1,513,0,101,,,,952,,,,2504,43,103,167,41,3,1,39,2274,1192,1053,685,368,139
2010,101,42101037900,42,33849.0,42,2229,29,12,32,14,2197,2,829,0,89,,,,2140,,,,5315,69,49,162,68,8,4,64,5053,2386,2229,1702,527,157
2010,101,42101038000,42,11353.0,42,866,7,80,120,20,746,4,303,2,211,,,,655,,,,2375,18,256,460,101,8,7,224,1761,960,866,549,317,94
2010,101,42101038100,42,28234.0,42,289,1,73,36,11,253,1,102,0,116,,,,173,,,,833,2,224,160,44,2,0,73,488,332,289,151,138,43
2010,101,42101038200,42,33427.0,42,910,12,120,192,25,718,5,305,0,322,,,,588,,,,2631,29,390,740,143,18,0,356,1695,1032,910,542,368,122
2010,101,42101038300,42,33074.0,42,1024,7,245,742,48,282,9,295,1,960,,,,64,,,,4157,32,1506,2426,205,34,4,1390,986,1126,1024,511,513,102
2010,101,42101038400,42,30446.0,42,976,33,71,24,8,952,0,291,0,132,,,,844,,,,2437,93,177,54,40,0,0,11,2116,1007,976,797,179,31
2010,101,42101038500,42,19510.0,42,890,27,44,13,11,877,0,435,0,96,,,,794,,,,1888,69,92,45,29,4,0,15,1679,939,890,505,385,49
2010,101,42101038600,42,21765.0,42,572,7,70,5,10,567,0,191,0,94,,,,478,,,,1320,21,166,26,24,1,0,8,1100,605,572,426,146,33
2010,101,42101038700,42,36481.0,42,702,13,39,12,6,690,0,241,0,71,,,,631,,,,2348,48,295,72,51,3,1,8,1942,735,702,566,136,33
2010,101,42101038800,42,30762.0,42,1765,23,632,40,49,1725,3,855,2,735,,,,1030,,,,3718,88,1226,140,145,10,4,19,2226,1905,1765,1152,613,140
2010,101,42101038900,42,34281.0,42,1249,2,1160,25,39,1224,4,510,0,1217,,,,32,,,,3080,6,2824,99,85,5,0,28,132,1343,1249,719,530,94
2010,101,42101039000,42,33005.0,42,2629,85,1445,530,64,2099,8,659,3,2060,,,,569,,,,8154,269,4728,1935,270,25,15,992,1855,2827,2629,1482,1147,198
2010,101,42101980000,42,52625.0,42,82,5,13,2,3,80,0,57,0,23,,,,59,,,,601,79,144,32,23,2,0,5,348,85,82,45,37,3
2010,101,42101980100,42,79808.0,42,40,0,3,2,1,38,0,21,0,6,,,,34,,,,74,1,4,6,2,0,0,0,67,46,40,23,17,6
2010,101,42101980200,42,69004.0,42,65,3,1,1,0,64,0,18,0,5,,,,60,,,,504,9,10,12,4,0,0,5,476,65,65,61,4,0
2010,101,42101980300,42,64938.0,42,1,0,0,0,0,1,0,0,0,0,,,,1,,,,2,0,0,0,0,0,0,0,2,1,1,1,0,0
2010,101,42101980400,42,57083.0,42,0,0,0,0,0,0,0,0,0,0,,,,0,,,,0,0,0,0,0,0,0,0,0,0,0,0,0,0
2010,101,42101980500,42,37472.0,42,0,0,0,0,0,0,0,0,0,0,,,,0,,,,0,0,0,0,0,0,0,0,0,0,0,0,0,0
2010,101,42101980600,42,44885.0,42,0,0,0,0,0,0,0,0,0,0,,,,0,,,,0,0,0,0,0,0,0,0,0,0,0,0,0,0
2010,101,42101980700,42,53013.0,42,1,0,1,0,0,1,0,1,0,1,,,,0,,,,5,1,4,1,0,0,0,0,0,1,1,0,1,0
2010,101,42101980800,42,50093.0,42,4,0,1,0,1,4,0,3,0,2,,,,2,,,,6,0,1,0,1,0,0,0,4,4,4,1,3,0
2010,101,42101980900,42,41494.0,42,19,0,12,0,1,19,0,13,0,13,,,,6,,,,30,0,20,2,1,0,0,0,9,20,19,2,17,1
2010,101,42101989100,42,41114.0,42,0,0,0,0,0,0,0,0,0,0,,,,0,,,,7765,51,5564,1231,16,0,0,1112,1022,0,0,0,0,0
