"","g_yr","g_id","g_st","g_cy","t_p","t_p_wh","t_p_bl","t_p_na","t_p_as","t_p_nh","t_p_or","t_p_mr","I","t_h","t_h_wh","t_h_bl","t_h_na","t_h_as","t_h_nh","t_h_or","t_h_mr","t_h_hi","t_h_n_hi","t_h_wa","t_h_nw","t_h_nf","t_u","t_u_oc","t_u_vc","t_u_oc_ro","t_u_oc_oo"
"1","2010",34005700102,34,5,2638,2420,109,4,32,3,24,46,80045,1052,983,45,1,7,2,6,8,17,1035,974,78,315,1118,1052,66,175,877
"2","2010",34005700103,34,5,2839,2343,303,7,76,3,40,67,65429,1401,1190,141,5,33,2,16,14,56,1345,1156,245,672,1519,1401,118,375,1026
"3","2010",34005700104,34,5,1921,1063,664,12,28,0,80,74,47317,703,419,230,7,8,0,20,19,43,660,403,300,231,755,703,52,264,439
"4","2010",34005700200,34,5,2779,2596,92,3,21,2,13,52,96848,1057,1001,33,1,4,0,5,13,22,1035,984,73,302,1112,1057,55,230,827
"5","2010",34005700303,34,5,2897,2166,514,2,88,0,48,79,64250,1107,857,190,1,28,0,14,17,41,1066,832,275,338,1187,1107,80,203,904
"6","2010",34005700304,34,5,2454,2254,88,0,30,3,39,40,85000,881,836,23,0,8,0,9,5,19,862,826,55,204,907,881,26,51,830
"7","2010",34005700305,34,5,4894,4560,123,5,128,0,15,63,97813,1762,1657,46,1,38,0,5,15,32,1730,1633,129,383,1832,1762,70,67,1695
"8","2010",34005700306,34,5,2542,2383,54,2,42,0,38,23,96250,864,822,13,1,13,0,9,6,17,847,812,52,136,892,864,28,27,837
"9","2010",34005700307,34,5,2782,2568,76,4,82,0,13,39,101500,921,863,23,1,22,0,4,8,13,908,853,68,122,940,921,19,13,908
"10","2010",34005700401,34,5,2051,1955,21,0,29,1,13,32,79569,783,756,6,0,8,0,4,9,14,769,748,35,246,816,783,33,89,694
"11","2010",34005700402,34,5,3345,3126,81,4,44,0,32,58,78917,1283,1233,11,2,11,0,10,16,37,1246,1208,75,368,1323,1283,40,101,1182
"12","2010",34005700403,34,5,4438,4087,139,1,96,1,64,50,60694,1676,1584,36,1,21,0,19,15,57,1619,1551,125,587,1763,1676,87,445,1231
"13","2010",34005700405,34,5,1643,1513,35,1,43,0,23,28,67094,668,622,17,1,15,0,8,5,17,651,613,55,228,694,668,26,136,532
"14","2010",34005700407,34,5,5529,2872,1253,21,648,2,410,323,50266,2819,1645,626,9,254,2,142,141,349,2470,1502,1317,1574,3139,2819,320,2480,339
"15","2010",34005700408,34,5,2125,1487,297,4,220,1,59,57,39745,1296,961,177,3,99,1,28,27,78,1218,920,376,864,1451,1296,155,1135,161
"16","2010",34005700501,34,5,5483,4625,428,6,219,2,61,142,90855,2133,1855,159,4,62,2,18,33,62,2071,1822,311,590,2228,2133,95,578,1555
"17","2010",34005700502,34,5,2215,1970,87,2,83,0,35,38,88125,816,745,31,1,24,0,8,7,27,789,724,92,231,860,816,44,175,641
"18","2010",34005700503,34,5,3713,2976,473,8,91,2,34,129,118676,1341,1069,198,2,28,1,9,34,46,1295,1040,301,296,1402,1341,61,230,1111
"19","2010",34005700504,34,5,3136,2813,196,0,61,1,17,48,97143,1130,1032,71,0,14,0,5,8,25,1105,1013,117,329,1219,1130,89,311,819
"20","2010",34005700505,34,5,6179,5129,147,2,790,0,21,90,228000,2030,1755,53,0,212,0,2,8,33,1997,1725,305,380,2153,2030,123,262,1768
"21","2010",34005700602,34,5,6505,5226,565,10,412,5,104,183,94167,2316,1937,194,4,118,2,26,35,72,2244,1892,424,579,2389,2316,73,176,2140
"22","2010",34005700603,34,5,5621,4232,761,14,172,1,270,171,71980,2120,1587,335,4,55,1,95,43,112,2008,1539,581,605,2296,2120,176,852,1268
"23","2010",34005700605,34,5,4770,4230,290,9,99,1,85,56,87656,1712,1514,127,5,26,0,28,12,37,1675,1490,222,330,1757,1712,45,361,1351
"24","2010",34005700701,34,5,3205,2654,148,13,28,0,168,194,66307,1222,1055,49,3,7,0,51,57,69,1153,1031,191,391,1259,1222,37,346,876
"25","2010",34005700702,34,5,2451,1892,186,7,31,0,216,119,53934,886,732,64,2,10,0,57,21,79,807,694,192,288,961,886,75,375,511
"26","2010",34005700703,34,5,2423,1934,182,1,18,4,185,99,55929,851,709,63,0,6,1,47,25,67,784,677,174,253,927,851,76,297,554
"27","2010",34005700800,34,5,4283,3546,470,20,80,5,40,122,81531,1755,1493,197,5,25,1,10,24,47,1708,1464,291,514,1853,1755,98,309,1446
"28","2010",34005700900,34,5,2577,1589,770,4,20,0,69,125,53112,1002,664,284,3,6,0,17,28,57,945,638,364,331,1086,1002,84,316,686
"29","2010",34005701001,34,5,4862,2822,1364,19,153,2,244,258,48393,2288,1375,672,8,49,1,79,104,188,2100,1299,989,1029,2484,2288,196,1083,1205
"30","2010",34005701002,34,5,4019,2303,1062,11,130,0,333,180,76750,1395,870,360,3,32,0,90,40,104,1291,835,560,330,1442,1395,47,328,1067
"31","2010",34005701102,34,5,5516,3675,1224,9,331,1,94,182,90795,1917,1278,479,4,94,1,27,34,96,1821,1223,694,607,1988,1917,71,371,1546
"32","2010",34005701103,34,5,6371,3684,1789,6,490,1,146,255,105744,2075,1219,627,2,129,1,42,55,112,1963,1166,909,388,2125,2075,50,277,1798
"33","2010",34005701104,34,5,4556,2591,1299,9,333,5,177,142,52813,1708,996,524,3,81,2,60,42,99,1609,954,754,486,1785,1708,77,585,1123
"34","2010",34005701105,34,5,6151,3381,2010,11,436,2,127,184,84435,2097,1248,646,3,109,1,40,50,121,1976,1191,906,571,2207,2097,110,450,1647
"35","2010",34005701201,34,5,2967,1906,862,2,64,0,47,86,71083,1131,785,297,0,19,0,12,18,46,1085,761,370,334,1193,1131,62,206,925
"36","2010",34005701203,34,5,1857,1309,419,5,46,3,31,44,58958,752,544,177,1,14,1,8,7,34,718,522,230,252,788,752,36,263,489
"37","2010",34005701204,34,5,2818,1023,1521,5,41,0,78,150,45024,1048,484,501,2,11,0,18,32,45,1003,474,574,462,1203,1048,155,669,379
"38","2010",34005701205,34,5,2278,1607,470,6,50,1,71,73,43040,927,683,188,2,12,0,22,20,46,881,665,262,373,1039,927,112,332,595
"39","2010",34005701301,34,5,4426,3284,746,7,127,2,72,188,67348,1857,1448,298,1,43,1,25,41,58,1799,1426,431,691,1998,1857,141,560,1297
"40","2010",34005701302,34,5,2649,2346,129,6,101,0,10,57,77650,1047,957,46,3,24,0,3,14,21,1026,946,101,355,1091,1047,44,177,870
"41","2010",34005701303,34,5,5034,3867,606,10,382,5,39,125,92688,1871,1511,208,4,108,2,10,28,74,1797,1458,413,444,1964,1871,93,184,1687
"42","2010",34005701401,34,5,6495,4848,840,11,579,5,45,167,117331,2232,1766,268,6,155,1,14,22,97,2135,1702,530,418,2305,2232,73,155,2077
"43","2010",34005701402,34,5,2049,1905,50,3,78,0,8,5,51911,1169,1118,23,1,22,0,3,2,16,1153,1106,63,531,1224,1169,55,42,1127
"44","2010",34005701502,34,5,3724,3139,212,13,234,0,64,62,58892,1549,1336,102,4,69,0,23,15,79,1470,1289,260,515,1664,1549,115,517,1032
"45","2010",34005701700,34,5,3924,3277,397,8,107,1,46,88,66885,1859,1610,171,3,34,1,19,21,75,1784,1560,299,937,2014,1859,155,878,981
"46","2010",34005702101,34,5,2887,1978,468,9,69,25,126,212,50645,892,640,149,7,17,5,44,30,119,773,578,314,123,1391,892,499,888,4
"47","2010",34005702203,34,5,3309,1776,1073,12,108,1,163,176,55657,1357,762,444,7,38,0,62,44,171,1186,681,676,517,1465,1357,108,505,852
"48","2010",34005702204,34,5,2289,1401,604,4,26,1,134,119,43571,638,430,146,3,7,1,34,17,85,553,387,251,154,700,638,62,268,370
"49","2010",34005702206,34,5,1875,1498,226,6,23,1,40,81,56173,714,580,86,3,7,0,13,25,49,665,546,168,248,772,714,58,152,562
"50","2010",34005702207,34,5,3682,2524,694,11,117,6,95,235,44076,1481,1069,272,5,51,3,38,43,118,1363,1005,476,582,1595,1481,114,390,1091
"51","2010",34005702208,34,5,7064,5256,1107,15,187,8,159,332,82212,2413,1875,365,8,49,5,41,70,175,2238,1770,643,518,2574,2413,161,210,2203
"52","2010",34005702209,34,5,3065,2255,481,14,94,1,38,182,61214,1065,808,167,7,26,1,18,38,91,974,756,309,269,1139,1065,74,159,906
"53","2010",34005702210,34,5,4863,2942,1192,32,210,2,169,316,43777,1756,1124,423,13,87,1,42,66,184,1572,1026,730,497,1859,1756,103,440,1316
"54","2010",34005702300,34,5,1409,1048,215,3,46,0,44,53,65833,581,448,85,1,17,0,11,19,52,529,420,161,177,642,581,61,194,387
"55","2010",34005702400,34,5,3414,3093,130,7,87,0,41,56,100586,1162,1075,44,1,20,0,12,10,30,1132,1056,106,221,1217,1162,55,100,1062
"56","2010",34005702500,34,5,6069,4437,1030,21,272,4,100,205,69375,2281,1709,395,9,83,2,36,47,149,2132,1618,663,642,2380,2281,99,725,1556
"57","2010",34005702601,34,5,4058,2994,710,12,71,5,108,158,73407,1566,1221,240,5,27,2,37,34,116,1450,1159,407,484,1655,1566,89,308,1258
"58","2010",34005702603,34,5,2316,1597,455,6,27,1,87,143,41806,852,624,160,3,10,0,27,28,70,782,594,258,335,968,852,116,450,402
"59","2010",34005702700,34,5,8813,5376,2243,17,608,3,199,367,96032,3195,2095,791,7,167,2,67,66,224,2971,1977,1218,766,3291,3195,96,250,2945
"60","2010",34005702801,34,5,2077,336,1554,8,31,1,66,81,82448,713,135,528,2,8,0,15,25,42,671,120,593,150,746,713,33,46,667
"61","2010",34005702802,34,5,3390,593,2482,22,67,4,88,134,75024,1128,242,808,8,19,2,25,24,75,1053,217,911,248,1177,1128,49,86,1042
"62","2010",34005702803,34,5,3936,708,2892,15,38,0,112,171,67961,1343,300,959,5,11,0,26,42,83,1260,265,1078,282,1406,1343,63,108,1235
"63","2010",34005702804,34,5,2647,511,1918,7,37,0,73,101,65250,971,237,678,3,10,0,18,25,57,914,216,755,246,1004,971,33,65,906
"64","2010",34005702805,34,5,3812,647,2747,17,116,1,130,154,66935,1254,276,871,5,28,1,40,33,84,1170,248,1006,250,1314,1254,60,108,1146
"65","2010",34005702806,34,5,3792,649,2718,21,62,1,138,203,65591,1184,250,835,5,21,0,33,40,93,1091,218,966,230,1269,1184,85,138,1046
"66","2010",34005702807,34,5,3184,659,2117,5,106,1,132,164,54839,1223,287,814,2,32,0,45,43,101,1122,254,969,427,1292,1223,69,457,766
"67","2010",34005702808,34,5,3356,537,2403,9,108,1,140,158,61033,1082,226,756,5,27,1,29,38,72,1010,204,878,215,1154,1082,72,107,975
"68","2010",34005702809,34,5,1402,214,1085,3,14,0,31,55,61033,615,123,454,1,5,0,13,19,28,587,116,499,256,653,615,38,137,478
"69","2010",34005702810,34,5,1405,245,1047,2,16,0,31,64,98833,459,106,328,1,5,0,9,10,27,432,102,357,103,486,459,27,28,431
"70","2010",34005702811,34,5,2628,376,2044,8,40,1,47,112,90662,912,162,692,5,8,0,12,33,42,870,146,766,190,941,912,29,44,868
"71","2010",34005702905,34,5,4120,3431,317,9,244,1,32,86,81875,1714,1465,127,2,98,1,8,13,55,1659,1424,290,645,1834,1714,120,569,1145
"72","2010",34005702906,34,5,2140,1803,153,1,131,2,19,31,92083,645,569,29,1,36,0,4,6,18,627,556,89,84,671,645,26,31,614
"73","2010",34005702907,34,5,2935,2738,70,5,77,0,7,38,72679,1234,1166,27,2,28,0,1,10,16,1218,1153,81,367,1267,1234,33,43,1191
"74","2010",34005702908,34,5,4423,4044,140,3,183,4,15,34,67143,1983,1861,48,2,60,1,4,7,22,1961,1841,142,744,2076,1983,93,82,1901
"75","2010",34005702909,34,5,6191,4612,689,5,666,2,58,159,96104,2507,1991,255,2,208,1,17,33,79,2428,1940,567,800,2565,2507,58,221,2286
"76","2010",34005702910,34,5,5585,4437,508,7,403,0,88,142,110602,2104,1738,199,3,110,0,25,29,78,2026,1693,411,607,2167,2104,63,325,1779
"77","2010",34005702913,34,5,4401,3027,705,4,464,1,56,144,70089,2437,1832,343,3,179,0,24,56,114,2323,1765,672,1388,2571,2437,134,815,1622
"78","2010",34005702914,34,5,4205,3443,363,3,244,0,46,106,91741,1506,1284,120,1,71,0,13,17,58,1448,1246,260,288,1558,1506,52,111,1395
"79","2010",34005702915,34,5,4262,2939,755,25,303,6,59,175,74135,1731,1255,298,9,102,5,20,42,87,1644,1206,525,594,1811,1731,80,458,1273
"80","2010",34005702917,34,5,1911,1482,197,0,180,0,14,38,113826,818,658,87,0,57,0,4,12,19,799,647,171,298,834,818,16,82,736
"81","2010",34005702918,34,5,1691,1293,164,5,145,1,24,59,88977,859,704,82,1,48,1,9,14,32,827,683,176,434,895,859,36,139,720
"82","2010",34005703000,34,5,6110,5180,458,6,249,0,87,130,85804,2239,1960,154,5,71,0,24,25,78,2161,1911,328,513,2305,2239,66,209,2030
"83","2010",34005703102,34,5,2673,2246,251,0,126,2,8,40,136607,884,761,74,0,34,0,5,10,21,863,745,139,135,918,884,34,90,794
"84","2010",34005703103,34,5,4768,2675,1423,20,279,0,144,227,65382,1955,1177,562,5,88,0,59,64,149,1806,1122,833,770,2043,1955,88,983,972
"85","2010",34005703104,34,5,5118,3995,704,10,186,3,43,177,96454,1701,1359,248,4,48,1,13,28,72,1629,1316,385,398,1758,1701,57,223,1478
"86","2010",34005703201,34,5,3687,3418,83,7,72,1,29,77,72097,1411,1332,29,5,20,1,9,15,29,1382,1316,95,368,1493,1411,82,149,1262
"87","2010",34005703202,34,5,2665,2517,42,2,38,0,19,47,85900,930,894,12,0,10,0,7,7,22,908,879,51,168,975,930,45,91,839
"88","2010",34005703203,34,5,4112,3953,106,3,29,0,3,18,34877,2405,2321,58,2,13,0,2,9,23,2382,2302,103,1170,2556,2405,151,145,2260
"89","2010",34005703600,34,5,6946,6654,96,5,48,4,65,74,95088,2374,2300,30,3,15,2,14,10,34,2340,2280,94,397,2444,2374,70,155,2219
"90","2010",34005703700,34,5,6493,6289,60,13,38,1,17,75,103500,2169,2122,15,3,10,0,4,15,29,2140,2101,68,343,2228,2169,59,91,2078
"91","2010",34005703801,34,5,6998,6592,119,24,131,0,30,102,114157,2486,2381,41,6,35,0,7,16,39,2447,2351,135,534,2637,2486,151,403,2083
"92","2010",34005703802,34,5,3894,3563,116,7,78,0,66,64,83125,1633,1520,54,2,25,0,17,15,40,1593,1501,132,631,1755,1633,122,615,1018
"93","2010",34005703803,34,5,4897,4712,27,1,87,0,21,49,92368,1758,1709,9,1,26,0,8,5,26,1732,1693,65,352,1796,1758,38,74,1684
"94","2010",34005703804,34,5,7244,6859,91,4,171,6,13,100,133529,2400,2308,27,1,45,1,2,16,26,2374,2287,113,305,2464,2400,64,94,2306
"95","2010",34005703900,34,5,4146,4035,19,7,40,0,16,29,102083,1483,1459,5,2,7,0,5,5,18,1465,1448,35,297,1543,1483,60,85,1398
"96","2010",34005704004,34,5,3701,3025,206,5,321,1,67,76,58947,1652,1387,102,2,113,0,21,27,76,1576,1344,308,720,1787,1652,135,774,878
"97","2010",34005704005,34,5,3757,3242,170,3,247,0,40,55,84583,1520,1333,71,0,87,0,15,14,36,1484,1315,205,520,1575,1520,55,362,1158
"98","2010",34005704006,34,5,2228,1684,177,3,270,0,38,56,97174,906,735,61,1,89,0,9,11,27,879,722,184,302,948,906,42,126,780
"99","2010",34005704007,34,5,3722,3479,75,9,89,0,31,39,62375,1403,1334,19,3,27,0,9,11,29,1374,1318,85,508,1463,1403,60,421,982
"100","2010",34005704008,34,5,5283,4837,99,7,249,1,16,74,102955,1965,1824,40,1,73,0,6,21,28,1937,1805,160,457,2058,1965,93,551,1414
"101","2010",34005704009,34,5,4569,3858,291,7,253,0,47,113,73160,1913,1662,120,3,84,0,18,26,60,1853,1629,284,732,2003,1913,90,859,1054
"102","2010",34005704011,34,5,3137,2942,75,1,83,0,8,28,106431,1033,981,25,0,19,0,1,7,14,1019,968,65,156,1063,1033,30,35,998
"103","2010",34005704012,34,5,5888,5360,235,9,140,2,34,108,83914,2583,2398,93,2,58,0,12,20,62,2521,2353,230,1020,2658,2583,75,323,2260
"104","2010",34005704013,34,5,5398,4665,212,0,351,4,39,127,109750,1746,1538,73,0,104,1,9,21,35,1711,1514,232,234,1776,1746,30,52,1694
"105","2010",34005704014,34,5,7855,6517,370,10,801,1,37,119,122212,2899,2473,142,4,242,1,15,22,69,2830,2428,471,659,2972,2899,73,394,2505
"106","2010",34005704200,34,5,8183,5754,1072,17,978,7,118,237,92558,2830,2178,301,2,265,1,36,47,115,2715,2117,713,627,2917,2830,87,397,2433
"107","2010",34005704302,34,5,4616,3584,289,7,620,1,20,95,117337,1523,1237,85,2,177,0,5,17,44,1479,1208,315,225,1578,1523,55,85,1438
"108","2010",34005704500,34,5,5480,4496,395,19,121,10,256,183,73277,2165,1825,169,8,50,3,70,40,157,2008,1758,407,726,2287,2165,122,649,1516
"109","2010",34005704600,34,5,3162,1662,1038,17,42,1,214,188,54209,1038,623,300,4,16,1,57,37,143,895,564,474,375,1238,1038,200,381,657
"110","2010",34005704700,34,5,3918,3652,162,3,27,0,38,36,68804,1254,1228,7,1,5,0,10,3,33,1221,1207,47,310,1365,1254,111,214,1040
"111","2010",34005704801,34,5,3122,2023,702,15,67,18,136,161,78723,805,592,142,3,21,4,11,32,71,734,548,257,182,887,805,82,585,220
"112","2010",34005704802,34,5,5318,2642,2007,44,99,5,356,165,88348,221,152,41,4,6,3,6,9,23,198,139,82,60,267,221,46,219,2
"113","2010",34005981802,34,5,3083,572,1953,32,23,1,366,136,107500,16,15,1,0,0,0,0,0,1,15,14,2,3,23,16,7,1,15
"114","2010",34005982111,34,5,823,585,134,8,29,0,14,53,53750,134,95,22,2,5,0,3,7,12,122,91,43,11,144,134,10,132,2
"115","2010",34007600200,34,7,2131,279,1326,12,11,4,428,71,38400,706,91,469,3,3,1,121,18,231,475,28,678,209,972,706,266,412,294
"116","2010",34007600400,34,7,3237,520,1685,25,9,0,890,108,22986,1025,141,568,8,4,0,270,34,431,594,28,997,286,1425,1025,400,667,358
"117","2010",34007600700,34,7,1475,354,454,8,1,0,598,60,37788,476,111,164,3,0,0,184,14,301,175,24,452,158,531,476,55,273,203
"118","2010",34007600800,34,7,5053,912,1789,52,23,0,2073,204,14570,1747,304,659,17,7,0,701,59,1117,630,30,1717,716,1940,1747,193,1299,448
"119","2010",34007600900,34,7,4456,964,1273,33,18,3,1931,234,20000,1299,279,410,9,4,1,539,57,859,440,59,1240,273,1392,1299,93,934,365
"120","2010",34007601000,34,7,5624,1591,1264,39,61,0,2381,288,38015,1667,476,421,11,13,0,671,75,1144,523,119,1548,396,1830,1667,163,756,911
"121","2010",34007601101,34,7,3268,656,739,26,251,4,1448,144,38567,864,167,231,7,62,1,366,30,557,307,19,845,188,955,864,91,507,357
"122","2010",34007601102,34,7,5567,1095,1546,47,630,7,2022,220,29477,1641,347,517,13,149,1,562,52,932,709,67,1574,414,1732,1641,91,891,750
"123","2010",34007601200,34,7,6660,1476,2451,50,234,5,2179,265,32608,1980,409,861,18,66,1,553,72,921,1059,151,1829,446,2112,1980,132,893,1087
"124","2010",34007601300,34,7,5184,921,2168,55,57,0,1773,210,23611,1597,267,750,21,17,0,480,62,823,774,32,1565,470,1873,1597,276,1035,562
"125","2010",34007601400,34,7,4494,153,3825,42,29,4,327,114,30208,1521,44,1342,13,8,1,82,31,153,1368,17,1504,457,1815,1521,294,675,846
"126","2010",34007601500,34,7,6058,544,4307,31,23,5,939,209,26449,2138,203,1553,10,9,0,305,58,571,1567,54,2084,717,2589,2138,451,1474,664
"127","2010",34007601600,34,7,2316,160,1806,20,8,0,256,66,28161,800,42,666,7,3,0,64,18,129,671,9,791,205,936,800,136,519,281
"128","2010",34007601700,34,7,2951,370,1926,15,15,0,552,73,16276,1166,141,817,8,7,0,173,20,315,851,46,1120,433,1303,1166,137,1005,161
"129","2010",34007601800,34,7,1291,196,672,2,84,0,284,53,27896,428,70,247,1,25,0,68,17,113,315,42,386,132,608,428,180,226,202
"130","2010",34007601900,34,7,2879,191,2035,24,4,1,540,84,16300,999,68,737,7,3,0,165,19,249,750,18,981,271,1100,999,101,624,375
"131","2010",34007602000,34,7,6799,1203,3929,52,38,10,1304,263,32635,2245,488,1286,13,15,2,378,63,615,1630,338,1907,644,2565,2245,320,1191,1054
"132","2010",34007602503,34,7,2567,568,1250,19,160,5,467,98,49881,834,211,426,6,35,1,134,21,243,591,128,706,191,872,834,38,125,709
"133","2010",34007602601,34,7,2684,1413,616,9,336,3,224,83,66179,928,549,212,3,83,2,59,20,148,780,477,451,234,966,928,38,105,823
"134","2010",34007602602,34,7,2883,1074,976,11,296,0,385,141,54873,998,435,346,4,69,0,110,34,235,763,342,656,294,1039,998,41,271,727
"135","2010",34007602901,34,7,4806,3447,690,16,297,0,236,120,71599,1874,1413,263,4,88,0,74,32,173,1701,1330,544,556,1963,1874,89,211,1663
"136","2010",34007602902,34,7,3220,1987,729,10,77,0,299,118,55054,1228,788,286,4,19,0,106,25,220,1008,698,530,369,1259,1228,31,365,863
"137","2010",34007603001,34,7,3726,2700,461,9,210,1,243,102,75792,1320,1037,148,4,46,0,58,27,143,1177,969,351,334,1385,1320,65,198,1122
"138","2010",34007603002,34,7,5012,1568,1380,45,590,1,1201,227,56164,1504,580,429,8,137,1,306,43,496,1008,448,1056,330,1581,1504,77,331,1173
"139","2010",34007603100,34,7,3821,2926,497,14,87,2,169,126,64057,1574,1259,196,5,28,2,60,24,143,1431,1196,378,607,1688,1574,114,613,961
"140","2010",34007603200,34,7,7055,5230,702,20,572,5,322,204,71789,2821,2216,279,6,187,3,79,51,213,2608,2107,714,1093,3073,2821,252,934,1887
"141","2010",34007603301,34,7,5660,3858,440,5,1039,2,161,155,61178,2256,1620,218,3,329,2,47,37,145,2111,1540,716,796,2476,2256,220,923,1333
"142","2010",34007603302,34,7,6072,4860,355,7,625,0,80,145,89474,2335,1973,135,4,173,0,23,27,77,2258,1926,409,644,2411,2335,76,321,2014
"143","2010",34007603303,34,7,2703,2061,222,0,311,0,70,39,41250,1307,1068,105,0,103,0,17,14,53,1254,1037,270,698,1367,1307,60,789,518
"144","2010",34007603400,34,7,6920,5270,485,14,907,1,80,163,84464,2596,2075,183,4,275,0,25,34,105,2491,2006,590,746,2967,2596,371,556,2040
"145","2010",34007603501,34,7,6237,4362,555,5,1145,0,44,126,110040,2304,1709,195,2,359,0,12,27,51,2253,1676,628,546,2388,2304,84,402,1902
"146","2010",34007603503,34,7,4747,3999,141,0,501,0,24,82,127857,1609,1396,43,0,156,0,3,11,22,1587,1378,231,160,1653,1609,44,25,1584
"147","2010",34007603504,34,7,2690,2202,144,1,276,0,13,54,108214,954,807,49,0,91,0,2,5,28,926,782,172,176,990,954,36,44,910
"148","2010",34007603505,34,7,3459,2674,228,5,426,0,47,79,78409,1201,978,75,1,120,0,12,15,54,1147,941,260,236,1234,1201,33,67,1134
"149","2010",34007603506,34,7,6379,5068,221,4,945,0,37,104,108269,2138,1768,62,2,282,0,8,16,44,2094,1737,401,293,2198,2138,60,115,2023
"150","2010",34007603507,34,7,7081,5700,271,10,926,2,40,132,111393,2701,2245,87,3,314,1,13,38,46,2655,2215,486,839,2827,2701,126,529,2172
"151","2010",34007603601,34,7,3616,3059,271,3,172,0,38,73,81625,1422,1258,88,1,54,0,12,9,45,1377,1231,191,504,1501,1422,79,138,1284
"152","2010",34007603602,34,7,2498,2365,21,2,66,0,11,33,102125,909,879,6,0,17,0,2,5,16,893,866,43,145,925,909,16,15,894
"153","2010",34007603603,34,7,2387,2186,54,1,88,0,14,44,101771,877,827,15,1,24,0,2,8,17,860,815,62,188,894,877,17,32,845
"154","2010",34007603700,34,7,3541,2565,250,1,305,3,321,96,60435,1452,1146,106,1,87,0,90,22,159,1293,1090,362,526,1548,1452,96,481,971
"155","2010",34007603800,34,7,5173,4945,48,5,72,0,37,66,100192,1970,1914,17,0,20,0,7,12,35,1935,1892,78,564,2034,1970,64,286,1684
"156","2010",34007603901,34,7,4874,4561,45,5,155,0,39,69,66644,2170,2066,18,2,55,0,10,19,42,2128,2037,133,883,2241,2170,71,750,1420
"157","2010",34007603902,34,7,2940,2714,66,7,68,0,47,38,58750,1431,1340,36,3,30,0,14,8,43,1388,1316,115,709,1506,1431,75,773,658
"158","2010",34007604100,34,7,2978,839,999,21,289,1,688,141,37361,917,320,318,10,74,1,161,33,279,638,242,675,217,1016,917,99,322,595
"159","2010",34007604200,34,7,3387,2721,291,13,79,0,183,100,71563,1501,1286,114,6,26,0,54,15,111,1390,1239,262,705,1596,1501,95,716,785
"160","2010",34007604300,34,7,3687,3345,126,9,58,0,49,100,62010,1683,1556,63,4,26,0,18,16,62,1621,1520,163,807,1832,1683,149,567,1116
"161","2010",34007604400,34,7,3207,2989,75,5,59,0,45,34,75813,1337,1277,22,0,20,0,12,6,47,1290,1244,93,484,1384,1337,47,339,998
"162","2010",34007604600,34,7,2107,1887,84,4,54,1,34,43,53320,957,873,47,1,15,0,15,6,55,902,841,116,461,1055,957,98,424,533
"163","2010",34007604700,34,7,1931,1844,16,5,19,0,26,21,82067,768,744,7,0,5,0,6,6,17,751,733,35,257,792,768,24,93,675
"164","2010",34007605100,34,7,2394,2295,20,2,34,0,9,34,65048,893,870,5,0,8,0,3,7,19,874,857,36,253,959,893,66,139,754
"165","2010",34007605200,34,7,2617,2276,120,10,95,0,72,44,58701,1035,948,32,1,26,0,19,9,47,988,923,112,346,1184,1035,149,178,857
"166","2010",34007605300,34,7,1955,1718,104,2,43,0,40,48,59143,759,696,32,2,9,0,11,9,31,728,680,79,243,806,759,47,174,585
"167","2010",34007605400,34,7,2652,2541,25,0,14,0,45,27,62463,1102,1067,10,0,5,0,14,6,31,1071,1052,50,421,1160,1102,58,219,883
"168","2010",34007605602,34,7,2827,2739,26,4,12,0,12,34,80455,1108,1079,16,0,3,0,3,7,22,1086,1062,46,361,1157,1108,49,262,846
"169","2010",34007605700,34,7,3582,3363,74,1,56,1,41,46,74671,1449,1378,31,1,19,1,8,11,44,1405,1351,98,531,1542,1449,93,406,1043
"170","2010",34007605800,34,7,2897,2750,38,5,53,0,19,32,83345,1152,1123,11,1,11,0,3,3,17,1135,1111,41,350,1195,1152,43,143,1009
"171","2010",34007605900,34,7,2573,2495,11,4,22,4,7,30,87344,1001,975,9,1,7,1,2,6,17,984,962,39,284,1039,1001,38,181,820
"172","2010",34007606000,34,7,2003,1888,35,3,23,1,14,39,100500,844,801,19,2,7,0,6,9,19,825,790,54,341,925,844,81,331,513
"173","2010",34007606100,34,7,2339,2262,9,0,32,0,5,31,114625,853,829,5,0,11,0,3,5,25,828,808,45,220,883,853,30,163,690
"174","2010",34007606200,34,7,3965,3767,28,1,96,0,11,62,103510,1544,1494,7,0,31,0,3,9,16,1528,1480,64,446,1604,1544,60,222,1322
"175","2010",34007606300,34,7,2237,2068,67,0,50,0,19,33,98639,970,915,29,0,13,0,5,8,20,950,902,68,387,1018,970,48,294,676
"176","2010",34007606400,34,7,3057,2948,25,3,37,0,15,29,180893,1072,1050,9,0,10,0,0,3,13,1059,1037,35,205,1132,1072,60,104,968
"177","2010",34007606500,34,7,2945,124,2616,19,42,0,49,95,54838,1103,50,996,8,8,0,16,25,36,1067,37,1066,341,1174,1103,71,307,796
"178","2010",34007606600,34,7,2288,2039,88,9,44,0,45,63,90588,986,902,39,4,12,0,18,11,57,929,868,118,356,1051,986,65,370,616
"179","2010",34007606700,34,7,4695,4215,270,7,74,0,57,72,51225,2002,1789,145,5,24,0,20,19,71,1931,1751,251,828,2107,2002,105,765,1237
"180","2010",34007606800,34,7,3942,3262,47,8,451,1,104,69,64129,1473,1288,20,3,113,0,27,22,80,1393,1236,237,438,1524,1473,51,283,1190
"181","2010",34007607000,34,7,4677,4195,77,6,117,4,200,78,48952,1941,1781,43,2,32,1,67,15,111,1830,1743,198,690,2016,1941,75,792,1149
"182","2010",34007607100,34,7,3902,3666,61,6,49,0,70,50,67625,1447,1386,19,3,11,0,19,9,42,1405,1363,84,399,1490,1447,43,156,1291
"183","2010",34007607200,34,7,4566,3830,339,19,174,0,115,89,45323,1923,1639,160,7,57,0,34,26,98,1825,1585,338,756,2058,1923,135,825,1098
"184","2010",34007607300,34,7,4339,3242,793,13,81,2,96,112,59528,1709,1316,311,5,29,0,26,22,93,1616,1267,442,562,1849,1709,140,454,1255
"185","2010",34007607401,34,7,2947,1946,582,2,196,0,104,117,54706,1158,811,240,1,51,0,28,27,75,1083,777,381,400,1228,1158,70,349,809
"186","2010",34007607402,34,7,2204,1567,396,2,113,1,54,71,54306,868,659,147,2,34,0,15,11,44,824,635,233,281,930,868,62,185,683
"187","2010",34007607502,34,7,6017,4909,345,8,597,4,40,114,89755,2337,2046,85,4,173,1,7,21,38,2299,2019,318,804,2456,2337,119,513,1824
"188","2010",34007607503,34,7,6540,4530,509,7,1302,4,42,146,97167,2318,1713,174,1,389,3,11,27,52,2266,1677,641,564,2444,2318,126,515,1803
"189","2010",34007607504,34,7,3692,3063,194,0,360,0,16,59,152273,1183,997,71,0,103,0,2,10,26,1157,974,209,115,1207,1183,24,31,1152
"190","2010",34007607505,34,7,4749,3542,394,6,675,1,21,110,126034,1552,1209,128,2,193,1,3,16,36,1516,1182,370,229,1582,1552,30,47,1505
"191","2010",34007607506,34,7,3030,1552,442,8,855,0,61,112,74180,1320,790,191,1,284,0,24,30,60,1260,761,559,576,1444,1320,124,646,674
"192","2010",34007607507,34,7,5103,3312,650,15,911,2,66,147,45486,2760,1954,351,6,366,0,28,55,92,2668,1900,860,1747,3127,2760,367,2000,760
"193","2010",34007607600,34,7,2274,2106,49,0,53,0,20,46,74444,786,747,18,0,10,0,3,8,23,763,729,57,160,809,786,23,60,726
"194","2010",34007607701,34,7,6030,1877,2414,47,180,0,1280,232,42645,2352,757,1105,19,66,0,342,63,611,1741,550,1802,954,2790,2352,438,1787,565
"195","2010",34007607702,34,7,3910,2210,1149,19,108,2,271,151,49077,1681,1038,494,8,40,2,70,29,158,1523,974,707,784,1783,1681,102,896,785
"196","2010",34007607801,34,7,5368,2639,2161,8,151,2,214,193,40470,2521,1300,1009,5,70,0,69,68,198,2323,1212,1309,1230,2760,2521,239,1579,942
"197","2010",34007607802,34,7,2305,1743,380,4,54,0,57,67,62204,872,694,131,1,18,0,16,12,52,820,664,208,246,918,872,46,189,683
"198","2010",34007607900,34,7,1908,1772,66,2,19,0,25,24,87083,727,675,38,1,4,0,5,4,18,709,664,63,221,771,727,44,168,559
"199","2010",34007608001,34,7,3507,2460,506,10,246,3,165,117,56023,1388,978,237,8,85,2,48,30,110,1278,939,449,545,1469,1388,81,677,711
"200","2010",34007608202,34,7,4101,3166,703,9,98,1,41,83,82147,1417,1086,262,4,32,1,17,15,51,1366,1064,353,261,1457,1417,40,188,1229
"201","2010",34007608205,34,7,4117,3776,215,0,62,0,40,24,93015,1375,1265,74,0,22,0,10,4,16,1359,1259,116,201,1404,1375,29,37,1338
"202","2010",34007608206,34,7,3569,3263,166,4,48,1,43,44,74945,1296,1201,57,3,15,1,10,9,30,1266,1183,113,300,1340,1296,44,81,1215
"203","2010",34007608209,34,7,3544,2613,652,3,113,6,70,87,52083,1416,1029,302,1,32,1,26,25,64,1352,1000,416,479,1493,1416,77,736,680
"204","2010",34007608210,34,7,3523,1915,1017,10,216,1,201,163,61250,1342,758,392,5,72,1,72,42,147,1195,716,626,489,1570,1342,228,868,474
"205","2010",34007608211,34,7,5615,3256,1602,20,424,2,142,169,83887,2177,1392,591,7,107,1,42,37,120,2057,1338,839,755,2323,2177,146,740,1437
"206","2010",34007608302,34,7,4786,4066,456,6,61,0,97,100,54341,2014,1747,195,3,19,0,26,24,86,1928,1701,313,901,2108,2014,94,1052,962
"207","2010",34007608303,34,7,3077,2608,261,2,79,0,43,84,62759,1129,949,131,1,24,0,9,15,50,1079,922,207,326,1200,1129,71,339,790
"208","2010",34007608304,34,7,6047,5225,488,7,166,1,87,73,64955,2797,2474,217,5,52,1,27,21,95,2702,2415,382,1223,2879,2797,82,789,2008
"209","2010",34007608401,34,7,4149,3425,490,7,98,2,59,68,84712,1316,1113,147,3,28,1,16,8,45,1271,1089,227,202,1353,1316,37,53,1263
"210","2010",34007608402,34,7,3683,2782,659,7,106,2,50,77,103158,1257,996,203,4,25,2,12,15,33,1224,978,279,279,1303,1257,46,67,1190
"211","2010",34007608403,34,7,7504,4519,1982,24,586,1,137,255,97663,2153,1347,579,4,145,1,43,34,107,2046,1294,859,237,2222,2153,69,240,1913
"212","2010",34007608404,34,7,6593,4546,1533,28,200,2,95,189,73650,2400,1718,541,6,67,2,27,39,81,2319,1673,727,647,2497,2400,97,321,2079
"213","2010",34007608503,34,7,2780,1427,1057,5,61,1,105,124,53750,1183,602,485,2,22,1,40,31,86,1097,579,604,497,1237,1183,54,615,568
"214","2010",34007608504,34,7,2897,1656,940,10,88,1,75,127,38106,1330,804,428,4,28,1,29,36,73,1257,778,552,622,1495,1330,165,768,562
"215","2010",34007608600,34,7,5000,3564,956,28,105,0,195,152,45667,2064,1508,411,13,29,0,58,45,137,1927,1451,613,837,2235,2064,171,795,1269
"216","2010",34007608700,34,7,7588,6865,318,7,211,3,67,117,69595,2806,2590,116,2,58,1,14,25,53,2753,2556,250,840,2949,2806,143,534,2272
"217","2010",34007608800,34,7,5357,4135,620,10,275,0,203,114,66630,1975,1590,218,2,77,0,58,30,106,1869,1551,424,612,2069,1975,94,493,1482
"218","2010",34007608901,34,7,5720,4943,427,8,88,0,137,117,72361,2046,1848,116,1,20,0,40,21,88,1958,1806,240,587,2136,2046,90,340,1706
"219","2010",34007608903,34,7,3443,3271,74,1,26,2,20,49,80156,1133,1087,29,1,7,0,5,4,20,1113,1072,61,182,1161,1133,28,34,1099
"220","2010",34007608904,34,7,1486,1433,13,2,10,1,9,18,83789,513,501,5,1,1,0,5,0,9,504,497,16,100,542,513,29,46,467
"221","2010",34007609000,34,7,1634,692,758,7,14,0,114,49,60750,582,276,268,3,2,0,24,9,43,539,263,319,206,621,582,39,113,469
"222","2010",34007609103,34,7,5439,3892,1169,12,123,1,105,137,67917,1880,1403,374,7,37,0,26,33,77,1803,1367,513,530,1991,1880,111,269,1611
"223","2010",34007609201,34,7,4494,2512,1644,9,61,5,121,142,62243,1730,1002,638,3,22,1,39,25,95,1635,961,769,516,1811,1730,81,448,1282
"224","2010",34007609202,34,7,4773,1125,3145,27,136,6,129,205,58750,1684,425,1120,10,43,2,41,43,100,1584,391,1293,471,1803,1684,119,488,1196
"225","2010",34007609203,34,7,9101,4307,3642,26,625,2,210,289,81622,3118,1664,1146,10,188,0,57,53,168,2950,1591,1527,706,3240,3118,122,399,2719
"226","2010",34007609204,34,7,4033,620,3044,15,47,0,107,200,46600,1401,324,981,5,12,0,33,46,86,1315,302,1099,410,1538,1401,137,386,1015
"227","2010",34007609205,34,7,6719,4774,1250,19,169,0,357,150,82673,2247,1671,402,6,43,0,87,38,175,2072,1611,636,468,2382,2247,135,390,1857
"228","2010",34007610300,34,7,2328,837,1086,5,84,3,222,91,15227,1026,348,521,4,29,1,94,29,201,825,272,754,786,1126,1026,100,854,172
"229","2010",34007610400,34,7,5573,1180,2899,50,57,2,1176,209,20917,1150,156,646,16,9,0,286,37,452,698,41,1109,356,1554,1150,404,658,492
"230","2010",34007610500,34,7,6603,1995,2352,36,643,3,1331,243,52585,2117,760,771,9,159,0,368,50,630,1487,559,1558,489,2193,2117,76,424,1693
"231","2010",34007610600,34,7,1254,775,268,6,90,1,84,30,39506,665,471,110,1,40,0,27,16,63,602,442,223,447,765,665,100,517,148
"232","2010",34007610800,34,7,3130,1554,922,49,71,1,407,126,57548,1165,615,342,24,20,1,125,38,253,912,520,645,392,1252,1165,87,318,847
"233","2010",34007610900,34,7,3433,3298,30,8,35,0,28,34,57500,1536,1490,18,5,7,0,6,10,26,1510,1475,61,627,1579,1536,43,598,938
"234","2010",34007611000,34,7,6445,5799,212,4,178,0,128,124,50140,2320,2165,65,4,42,0,22,22,91,2229,2105,215,846,2569,2320,249,957,1363
"235","2010",34007611100,34,7,2964,2555,161,3,111,2,88,44,50096,1256,1103,77,1,35,1,26,13,52,1204,1084,172,472,1343,1256,87,447,809
"236","2010",34007611200,34,7,4403,3963,205,9,86,2,79,59,68650,1630,1486,78,5,25,1,22,13,52,1578,1459,171,435,1712,1630,82,327,1303
"237","2010",34007611300,34,7,4328,3834,240,2,118,1,78,55,67113,1478,1346,71,0,30,0,19,12,52,1426,1321,157,401,1563,1478,85,248,1230
"238","2010",34007611400,34,7,4568,3831,466,12,68,3,68,120,71958,1577,1353,164,5,20,1,17,17,48,1529,1325,252,363,1647,1577,70,129,1448
"239","2010",34007611500,34,7,4940,4261,393,5,63,0,143,75,74923,1675,1554,59,2,14,0,31,15,68,1607,1521,154,454,1795,1675,120,165,1510
"240","2010",34007611600,34,7,4397,2938,820,24,164,2,311,138,50833,2084,1436,427,11,56,1,104,49,236,1848,1333,751,1068,2334,2084,250,1441,643
"241","2010",34007611700,34,7,2992,2710,92,4,68,2,72,44,67625,1156,1063,44,1,17,0,17,14,47,1109,1039,117,396,1222,1156,66,262,894
"242","2010",34015500100,34,15,4288,3839,210,7,64,2,99,67,56667,1755,1599,94,4,16,0,26,16,63,1692,1566,189,660,1912,1755,157,618,1137
"243","2010",34015500201,34,15,2537,2390,52,1,32,1,39,22,67188,980,944,18,1,7,1,6,3,18,962,934,46,289,1017,980,37,105,875
"244","2010",34015500202,34,15,4943,4360,369,4,74,2,26,108,65617,1838,1634,155,1,24,1,9,14,43,1795,1607,231,499,1909,1838,71,474,1364
"245","2010",34015500203,34,15,4727,4387,177,7,74,0,26,56,74160,1988,1851,73,3,33,0,10,18,50,1938,1818,170,746,2061,1988,73,479,1509
"246","2010",34015500204,34,15,6070,5134,549,7,211,0,79,90,76387,2559,2141,289,6,71,0,28,24,83,2476,2096,463,1045,2782,2559,223,1174,1385
"247","2010",34015500205,34,15,3400,3012,267,6,24,0,17,74,59679,1464,1331,99,5,8,0,6,15,23,1441,1317,147,496,1672,1464,208,210,1254
"248","2010",34015500300,34,15,3036,2923,41,5,18,0,4,45,62305,1092,1063,8,1,4,0,4,12,19,1073,1049,43,276,1153,1092,61,184,908
"249","2010",34015500400,34,15,6097,3322,2239,21,43,4,143,325,41096,2286,1373,799,6,14,3,39,52,134,2152,1312,974,696,2533,2286,247,939,1347
"250","2010",34015500500,34,15,4899,4567,196,3,37,0,20,76,66987,1946,1845,70,1,8,0,5,17,24,1922,1829,117,593,2048,1946,102,333,1613
"251","2010",34015500600,34,15,9555,8451,560,13,345,5,56,125,110586,3262,2942,178,9,95,2,15,21,73,3189,2896,366,615,3405,3262,143,266,2996
"252","2010",34015500701,34,15,7988,7434,275,11,92,0,60,116,64641,3187,2983,124,6,33,0,19,22,64,3123,2944,243,1048,3288,3187,101,360,2827
"253","2010",34015500702,34,15,5781,5525,80,16,69,0,26,65,81111,2031,1966,32,5,18,0,4,6,28,2003,1946,85,413,2168,2031,137,156,1875
"254","2010",34015500703,34,15,1448,1381,25,4,7,1,14,16,92850,501,489,5,1,2,1,1,2,5,496,485,16,90,524,501,23,36,465
"255","2010",34015500800,34,15,2278,2193,21,3,24,1,5,31,105924,829,813,5,1,5,1,1,3,8,821,806,23,180,860,829,31,80,749
"256","2010",34015500900,34,15,3055,2840,104,5,50,1,11,44,83011,1081,1031,29,2,11,0,2,6,14,1067,1020,61,249,1125,1081,44,96,985
"257","2010",34015501001,34,15,2175,1601,355,5,41,0,75,98,63333,806,637,118,0,12,0,20,19,58,748,605,201,272,869,806,63,210,596
"258","2010",34015501002,34,15,4244,2240,1562,14,31,22,197,178,37406,1810,1099,593,7,10,6,55,40,164,1646,1028,782,916,2014,1810,204,1101,709
"259","2010",34015501003,34,15,3755,2875,617,4,58,6,53,142,72353,1472,1172,242,2,13,1,16,26,69,1403,1132,340,479,1573,1472,101,398,1074
"260","2010",34015501101,34,15,4052,2848,782,11,41,0,238,132,35127,1847,1406,329,5,11,0,74,22,132,1715,1361,486,864,1958,1847,111,703,1144
"261","2010",34015501102,34,15,6697,5012,772,18,622,5,123,145,77628,2754,2130,352,8,180,2,51,31,125,2629,2073,681,1000,2857,2754,103,803,1951
"262","2010",34015501103,34,15,5517,4600,303,13,414,3,81,103,76418,1858,1623,95,3,104,1,15,17,74,1784,1576,282,382,1934,1858,76,178,1680
"263","2010",34015501104,34,15,3193,2770,206,8,94,2,52,61,68171,1085,962,67,3,25,1,16,11,52,1033,931,154,261,1128,1085,43,147,938
"264","2010",34015501105,34,15,2739,2148,373,9,84,1,48,76,56394,1184,969,153,3,29,1,17,12,66,1118,924,260,496,1365,1184,181,626,558
"265","2010",34015501106,34,15,3742,2380,1147,2,64,0,55,94,65764,1322,868,397,0,22,0,16,19,55,1267,838,484,333,1386,1322,64,183,1139
"266","2010",34015501107,34,15,4621,4324,134,12,42,1,25,83,77391,1639,1550,42,4,15,1,8,19,32,1607,1529,110,363,1733,1639,94,110,1529
"267","2010",34015501201,34,15,6254,5645,261,4,257,0,25,62,119071,1975,1800,88,0,69,0,6,12,29,1946,1779,196,209,2010,1975,35,69,1906
"268","2010",34015501202,34,15,4787,4434,132,2,156,0,5,58,108472,1524,1415,51,1,49,0,0,8,16,1508,1401,123,150,1549,1524,25,31,1493
"269","2010",34015501203,34,15,3369,3219,57,4,39,0,18,32,74375,1271,1223,21,3,10,0,5,9,30,1241,1201,70,341,1304,1271,33,92,1179
"270","2010",34015501204,34,15,3857,3560,150,0,73,4,20,50,82500,1310,1228,46,0,22,0,7,7,33,1277,1206,104,208,1330,1310,20,45,1265
"271","2010",34015501205,34,15,2958,2538,173,3,147,1,32,64,122216,988,869,64,1,38,0,5,11,29,959,847,141,239,1023,988,35,117,871
"272","2010",34015501206,34,15,3940,3412,243,8,128,4,37,108,72549,1501,1302,114,4,44,1,8,28,46,1455,1273,228,490,1578,1501,77,510,991
"273","2010",34015501208,34,15,3984,3678,106,1,148,0,19,32,74613,1700,1596,47,0,40,0,5,12,22,1678,1581,119,591,1776,1700,76,221,1479
"274","2010",34015501209,34,15,7022,5482,869,12,365,0,107,187,61387,2775,2203,378,6,109,0,47,32,118,2657,2148,627,862,2862,2775,87,1245,1530
"275","2010",34015501210,34,15,3698,3319,136,6,139,0,35,63,80474,1170,1051,56,3,43,0,4,13,21,1149,1037,133,122,1187,1170,17,32,1138
"276","2010",34015501212,34,15,3927,3050,517,5,161,0,78,116,70227,1367,1099,174,1,52,0,24,17,55,1312,1073,294,306,1429,1367,62,203,1164
"277","2010",34015501213,34,15,4763,4251,181,7,223,0,39,62,101280,1706,1538,72,2,74,0,8,12,40,1666,1509,197,437,1762,1706,56,252,1454
"278","2010",34015501301,34,15,3503,3381,44,0,23,3,11,41,68857,1348,1315,13,0,9,0,4,7,21,1327,1298,50,384,1409,1348,61,272,1076
"279","2010",34015501302,34,15,2780,2636,33,4,13,0,33,61,58877,1136,1093,13,3,4,0,10,13,24,1112,1078,58,420,1229,1136,93,382,754
"280","2010",34015501303,34,15,2728,2641,26,4,20,0,14,23,88583,1005,980,7,4,7,0,3,4,11,994,972,33,358,1067,1005,62,283,722
"281","2010",34015501402,34,15,3564,1916,1222,9,48,2,218,149,31597,1098,590,412,4,10,1,48,33,96,1002,563,535,454,1242,1098,144,575,523
"282","2010",34015501403,34,15,3742,2570,815,1,81,4,137,134,74195,1391,1020,282,1,28,0,33,27,73,1318,997,394,380,1488,1391,97,338,1053
"283","2010",34015501404,34,15,2895,2493,228,3,65,3,51,52,21992,548,495,25,1,12,1,6,8,21,527,483,65,367,578,548,30,344,204
"284","2010",34015501405,34,15,3870,3151,411,2,204,0,47,55,89130,1360,1147,142,1,51,0,11,8,44,1316,1116,244,343,1392,1360,32,121,1239
"285","2010",34015501406,34,15,4508,3293,793,6,136,1,127,152,58734,1761,1326,305,0,50,0,41,39,106,1655,1278,483,640,1890,1761,129,761,1000
"286","2010",34015501500,34,15,8179,6120,1473,30,147,2,130,277,72583,2916,2284,511,9,38,1,34,39,128,2788,2212,704,811,3128,2916,212,632,2284
"287","2010",34015501603,34,15,6545,5561,597,5,119,2,135,126,53409,2625,2289,243,4,33,1,32,23,92,2533,2242,383,853,2740,2625,115,639,1986
"288","2010",34015501604,34,15,7654,5951,1189,19,155,0,125,215,71120,2586,2039,413,7,46,0,38,43,100,2486,1987,599,665,2727,2586,141,678,1908
"289","2010",34015501605,34,15,4519,3591,663,12,72,0,75,106,58152,1757,1460,232,7,17,0,26,15,47,1710,1444,313,564,1847,1757,90,257,1500
"290","2010",34015501606,34,15,6911,5363,1083,15,165,1,104,180,84178,2262,1826,333,5,41,0,21,36,63,2199,1792,470,425,2345,2262,83,184,2078
"291","2010",34015501608,34,15,5126,4213,564,12,132,1,66,138,65733,1986,1699,196,4,37,1,22,27,68,1918,1661,325,640,2065,1986,79,295,1691
"292","2010",34015501609,34,15,5374,4010,964,10,232,1,52,105,113456,1599,1246,265,4,54,0,15,15,59,1540,1210,389,218,1663,1599,64,84,1515
"293","2010",34015501701,34,15,5381,4656,500,9,85,1,42,88,90278,1772,1578,148,4,19,0,10,13,37,1735,1557,215,320,1836,1772,64,103,1669
"294","2010",34015501702,34,15,2616,2397,122,6,24,0,27,40,88964,911,846,42,2,5,0,6,10,15,896,838,73,196,955,911,44,73,838
"295","2010",34015501703,34,15,4650,4008,386,9,70,0,78,99,74135,1659,1448,137,5,17,0,26,26,83,1576,1402,257,397,1724,1659,65,243,1416
"296","2010",34015501704,34,15,4173,3815,200,10,34,4,27,83,63289,1507,1404,65,3,7,1,7,20,41,1466,1370,137,372,1589,1507,82,191,1316
"297","2010",34015501800,34,15,1553,1470,34,4,5,0,15,25,62120,579,557,12,2,1,0,4,3,28,551,534,45,126,626,579,47,104,475
"298","2010",34015501900,34,15,4217,3363,623,22,27,0,72,110,66115,1475,1206,217,6,10,0,17,19,38,1437,1198,277,357,1577,1475,102,155,1320
"299","2010",34015502001,34,15,5641,5105,215,5,208,0,24,84,132803,1709,1560,85,1,43,0,5,15,36,1673,1533,176,231,1763,1709,54,232,1477
"300","2010",34015502002,34,15,6776,6141,260,6,212,0,35,122,108201,2233,2085,75,0,47,0,8,18,42,2191,2052,181,397,2326,2233,93,178,2055
"301","2010",34015502100,34,15,3161,2895,160,0,38,1,30,37,110395,1019,951,47,0,7,0,5,9,18,1001,938,81,157,1055,1019,36,50,969
"302","2010",34015502200,34,15,10200,8276,1017,13,614,0,80,200,113731,3141,2620,309,5,155,0,18,34,79,3062,2571,570,411,3275,3141,134,307,2834
"303","2010",34015502300,34,15,2584,1804,388,15,35,2,245,95,74722,938,706,146,6,10,0,52,18,94,844,675,263,293,1004,938,66,327,611
"304","2010",34015502400,34,15,6042,4926,755,9,154,1,68,129,89015,2087,1734,271,3,41,0,20,18,61,2026,1699,388,452,2172,2087,85,152,1935
"305","2010",42017100102,42,17,2720,2329,112,7,190,1,41,40,56929,1341,1186,54,4,66,1,16,14,43,1298,1163,178,662,1483,1341,142,941,400
"306","2010",42017100103,42,17,2402,1986,227,10,71,0,57,51,46531,1045,883,98,4,24,0,22,14,53,992,861,184,453,1122,1045,77,457,588
"307","2010",42017100104,42,17,4498,2700,455,18,767,9,377,172,38125,1692,1102,203,8,231,2,97,49,221,1471,1008,684,515,1890,1692,198,1144,548
"308","2010",42017100105,42,17,3297,3093,39,5,58,1,33,68,67313,1181,1131,10,1,14,0,7,18,29,1152,1112,69,315,1231,1181,50,206,975
"309","2010",42017100201,42,17,4422,3300,710,2,199,2,91,118,59222,1637,1297,242,2,49,0,25,22,41,1596,1284,353,476,1698,1637,61,213,1424
"310","2010",42017100206,42,17,4838,3714,305,14,619,0,87,99,74570,1826,1470,127,4,174,0,23,28,79,1747,1423,403,552,1968,1826,142,778,1048
"311","2010",42017100207,42,17,4246,3188,440,1,412,0,78,127,51136,1744,1420,164,0,105,0,24,31,59,1685,1389,355,540,1857,1744,113,959,785
"312","2010",42017100208,42,17,6429,4065,538,36,790,5,783,212,42380,2516,1753,252,15,243,2,202,49,382,2134,1605,911,943,2737,2516,221,1499,1017
"313","2010",42017100209,42,17,9452,5728,852,182,1852,1,480,357,64351,3683,2546,331,42,537,1,133,93,283,3400,2456,1227,1325,3960,3683,277,2152,1531
"314","2010",42017100210,42,17,7408,6161,335,12,648,0,98,154,74091,2629,2314,97,5,167,0,20,26,74,2555,2265,364,606,2692,2629,63,178,2451
"315","2010",42017100211,42,17,6710,5910,297,7,302,4,84,106,81978,2906,2617,125,3,102,1,28,30,92,2814,2564,342,1138,3185,2906,279,1192,1714
"316","2010",42017100212,42,17,4005,3538,109,2,255,0,44,57,79962,1399,1270,35,1,72,0,12,9,33,1366,1249,150,290,1423,1399,24,62,1337
"317","2010",42017100302,42,17,5084,4652,128,18,62,1,112,111,60309,1791,1695,29,6,11,0,28,22,69,1722,1661,130,480,1876,1791,85,316,1475
"318","2010",42017100303,42,17,5176,2926,1614,9,90,5,307,225,51406,1804,1120,539,5,24,1,74,41,154,1650,1051,753,542,1917,1804,113,631,1173
"319","2010",42017100304,42,17,2319,1606,446,4,98,1,83,81,38795,1001,707,202,3,36,1,36,16,72,929,685,316,448,1096,1001,95,615,386
"320","2010",42017100306,42,17,3450,2216,546,11,419,1,147,110,48849,1297,877,214,3,126,1,38,38,73,1224,851,446,374,1394,1297,97,423,874
"321","2010",42017100307,42,17,5027,4106,366,7,231,0,187,130,52289,1946,1636,160,5,56,0,57,32,138,1808,1567,379,675,2098,1946,152,718,1228
"322","2010",42017100401,42,17,6677,5551,498,16,219,2,201,190,56827,2427,2093,175,4,65,1,46,43,119,2308,2027,400,746,2601,2427,174,590,1837
"323","2010",42017100402,42,17,6471,5741,375,16,70,1,114,154,60617,2291,2088,121,3,21,0,30,28,111,2180,2017,274,623,2386,2291,95,495,1796
"324","2010",42017100403,42,17,2102,1211,785,8,13,0,33,52,54226,770,484,256,3,5,0,10,12,17,753,477,293,209,829,770,59,197,573
"325","2010",42017100404,42,17,6363,5536,374,22,72,1,186,172,58728,2309,2047,146,6,19,0,50,41,122,2187,1991,318,628,2396,2309,87,484,1825
"326","2010",42017100406,42,17,3839,3319,196,2,165,0,74,83,65531,1475,1324,62,1,54,0,17,17,42,1433,1303,172,490,1498,1475,23,436,1039
"327","2010",42017100407,42,17,1299,1180,30,5,23,0,17,44,60536,481,457,7,1,4,0,4,8,12,469,452,29,120,489,481,8,39,442
"328","2010",42017100408,42,17,6775,6146,218,18,84,6,130,173,65721,2249,2098,56,6,23,1,29,36,84,2165,2050,199,456,2307,2249,58,160,2089
"329","2010",42017100500,42,17,2680,2516,38,5,8,0,57,56,55466,1099,1051,12,3,2,0,18,13,47,1052,1026,73,403,1161,1099,62,309,790
"330","2010",42017100600,42,17,3737,3019,319,7,18,1,227,146,49254,1580,1331,116,4,7,0,90,32,185,1395,1252,328,688,1726,1580,146,868,712
"331","2010",42017100700,42,17,3309,2355,569,10,30,0,208,137,43203,1273,1000,163,4,12,0,72,22,190,1083,899,374,472,1350,1273,77,578,695
"332","2010",42017100803,42,17,4706,4299,123,16,114,0,55,99,68375,1687,1560,53,3,39,0,14,18,46,1641,1533,154,414,1725,1687,38,290,1397
"333","2010",42017100804,42,17,3900,3595,84,26,70,0,41,84,83766,1214,1158,19,6,14,0,9,8,23,1191,1143,71,217,1239,1214,25,72,1142
"334","2010",42017100805,42,17,6246,5904,91,12,120,1,40,78,87635,2166,2081,28,3,33,0,7,14,29,2137,2062,104,457,2219,2166,53,306,1860
"335","2010",42017100807,42,17,4208,3782,191,8,156,0,37,34,67500,1690,1599,31,2,45,0,4,9,24,1666,1581,109,573,1777,1690,87,338,1352
"336","2010",42017100808,42,17,5254,4907,68,1,176,2,34,66,95250,2008,1897,26,0,65,1,7,12,26,1982,1880,128,646,2111,2008,103,597,1411
"337","2010",42017100809,42,17,5774,5308,112,4,274,3,26,47,118185,2042,1892,48,0,78,0,8,16,42,2000,1860,182,383,2104,2042,62,367,1675
"338","2010",42017100811,42,17,4547,3123,595,16,543,2,99,169,48973,1898,1370,265,5,176,1,34,47,94,1804,1323,575,732,2021,1898,123,1327,571
"339","2010",42017100900,42,17,7563,7084,113,20,206,0,46,94,88450,2692,2577,34,5,54,0,10,12,47,2645,2544,148,591,2755,2692,63,264,2428
"340","2010",42017101100,42,17,2328,1961,201,1,64,0,27,74,50625,910,783,81,1,17,0,8,20,33,877,762,148,370,964,910,54,425,485
"341","2010",42017101401,42,17,4305,4020,54,5,143,0,32,51,79145,1579,1514,13,2,34,0,7,9,25,1554,1497,82,372,1613,1579,34,117,1462
"342","2010",42017101403,42,17,5560,5339,63,13,89,1,17,38,89357,2088,2033,19,3,23,0,2,8,20,2068,2016,72,457,2152,2088,64,101,1987
"343","2010",42017101404,42,17,2420,2291,34,2,63,0,3,27,82404,863,829,10,1,16,0,1,6,14,849,817,46,173,898,863,35,130,733
"344","2010",42017101405,42,17,6624,6068,187,9,186,3,76,95,57100,2613,2438,72,4,52,1,23,23,77,2536,2392,221,843,2699,2613,86,1016,1597
"345","2010",42017101503,42,17,3786,3562,33,2,116,0,30,43,65625,1538,1484,10,1,27,0,6,10,14,1524,1478,60,460,1587,1538,49,169,1369
"346","2010",42017101504,42,17,2819,2735,6,1,54,7,1,15,59250,1201,1186,3,1,10,1,0,0,5,1196,1182,19,505,1284,1201,83,367,834
"347","2010",42017101505,42,17,3330,3185,32,2,60,2,1,48,104152,1144,1106,7,1,17,1,0,12,9,1135,1098,46,189,1166,1144,22,50,1094
"348","2010",42017101506,42,17,5217,5027,44,7,50,2,28,59,67750,2015,1960,17,3,14,0,8,13,30,1985,1941,74,508,2083,2015,68,317,1698
"349","2010",42017101603,42,17,3193,2815,85,2,71,0,140,80,54675,1206,1117,23,0,20,0,35,11,59,1147,1093,113,383,1238,1206,32,394,812
"350","2010",42017101605,42,17,4130,2511,437,33,138,8,760,243,29673,1548,1064,171,8,50,2,204,49,389,1159,914,634,529,1603,1548,55,1218,330
"351","2010",42017101607,42,17,3152,2957,57,4,45,0,45,44,52708,1350,1300,17,1,10,0,13,9,36,1314,1279,71,538,1411,1350,61,360,990
"352","2010",42017101609,42,17,4415,4155,56,2,87,6,68,41,77330,1692,1625,18,1,24,1,15,8,31,1661,1609,83,431,1722,1692,30,147,1545
"353","2010",42017101610,42,17,4785,4529,104,7,67,4,31,43,83639,1731,1664,28,1,22,1,7,8,29,1702,1647,84,394,1772,1731,41,123,1608
"354","2010",42017101611,42,17,6900,6575,81,9,125,0,55,55,74814,2545,2447,28,3,39,0,13,15,38,2507,2427,118,516,2603,2545,58,183,2362
"355","2010",42017101802,42,17,6554,5776,92,7,569,1,44,65,127614,1947,1742,36,4,151,0,8,6,23,1924,1724,223,210,1975,1947,28,55,1892
"356","2010",42017101803,42,17,8247,7480,101,8,510,3,39,106,83838,3031,2828,39,2,137,1,9,15,53,2978,2787,244,708,3120,3031,89,253,2778
"357","2010",42017101805,42,17,2302,2177,19,4,67,1,12,22,116630,757,728,8,2,16,0,1,2,7,750,722,35,130,771,757,14,41,716
"358","2010",42017101807,42,17,4058,3349,231,16,159,0,215,88,71771,1421,1226,76,5,45,0,55,14,105,1316,1187,234,288,1465,1421,44,484,937
"359","2010",42017101808,42,17,2257,1938,55,2,122,0,88,52,71628,1017,922,27,0,37,0,21,10,46,971,900,117,443,1111,1017,94,496,521
"360","2010",42017101900,42,17,4009,3773,57,12,121,1,13,32,88690,1469,1405,16,2,35,0,4,7,20,1449,1389,80,375,1556,1469,87,215,1254
"361","2010",42017102002,42,17,2726,2606,36,0,60,0,6,18,95789,958,924,13,0,16,0,2,3,9,949,917,41,170,986,958,28,96,862
"362","2010",42017102003,42,17,3937,3680,58,1,158,3,5,32,96830,1383,1310,20,0,47,1,1,4,29,1354,1283,100,272,1429,1383,46,120,1263
"363","2010",42017102004,42,17,4407,4113,83,1,144,0,17,49,96284,1800,1720,27,0,41,0,2,10,25,1775,1701,99,606,1851,1800,51,277,1523
"364","2010",42017102102,42,17,3129,3049,13,6,26,1,9,25,85250,1144,1127,3,2,4,0,3,5,10,1134,1121,23,245,1188,1144,44,151,993
"365","2010",42017102104,42,17,5702,5154,138,2,232,4,69,103,69097,2128,1978,43,0,69,1,19,18,64,2064,1934,194,572,2203,2128,75,474,1654
"366","2010",42017102300,42,17,5706,5517,40,13,36,2,31,67,77768,2030,1983,13,5,8,0,9,12,21,2009,1972,58,436,2120,2030,90,297,1733
"367","2010",42017102401,42,17,3893,3753,49,4,25,3,15,44,59634,1584,1552,13,1,4,0,5,9,26,1558,1531,53,546,1634,1584,50,522,1062
"368","2010",42017102402,42,17,4618,4403,39,14,61,1,24,76,71591,1722,1658,11,5,20,0,8,20,29,1693,1637,85,485,1762,1722,40,471,1251
"369","2010",42017102500,42,17,4307,4032,79,13,43,0,41,99,65449,1741,1673,22,5,13,0,10,18,40,1701,1647,94,604,1824,1741,83,506,1235
"370","2010",42017102600,42,17,2207,1960,32,2,115,2,47,49,51985,1040,977,10,2,29,1,12,9,43,997,952,88,541,1072,1040,32,519,521
"371","2010",42017102700,42,17,5198,4993,58,12,74,0,12,49,54543,2121,2071,16,4,18,0,4,8,19,2102,2056,65,734,2247,2121,126,567,1554
"372","2010",42017102801,42,17,3529,3384,37,3,45,3,7,50,95188,1234,1194,12,0,16,1,2,9,10,1224,1186,48,225,1277,1234,43,126,1108
"373","2010",42017103101,42,17,2377,2206,56,4,22,1,24,64,52583,941,893,13,2,9,0,9,15,28,913,876,65,348,999,941,58,369,572
"374","2010",42017103102,42,17,1976,1828,35,13,16,0,58,26,48542,829,779,15,3,7,0,18,7,38,791,765,64,322,875,829,46,339,490
"375","2010",42017103103,42,17,4626,4101,126,12,141,1,162,83,54128,1879,1727,44,3,44,1,39,21,67,1812,1704,175,767,2002,1879,123,800,1079
"376","2010",42017103300,42,17,2225,2157,22,1,12,1,9,23,86098,894,878,7,0,2,0,2,5,4,890,875,19,233,947,894,53,107,787
"377","2010",42017103400,42,17,5035,4916,20,7,38,0,19,35,64714,2017,1984,9,2,6,0,4,12,20,1997,1968,49,541,2142,2017,125,284,1733
"378","2010",42017103700,42,17,3441,3350,9,3,11,0,21,47,67923,1378,1350,4,3,1,0,7,13,17,1361,1338,40,397,1493,1378,115,261,1117
"379","2010",42017103800,42,17,1277,1252,5,1,7,0,2,10,63542,569,562,4,1,1,0,0,1,7,562,555,14,211,622,569,53,126,443
"380","2010",42017103900,42,17,3995,3834,52,9,31,0,24,45,76360,1645,1608,7,2,5,0,6,17,26,1619,1593,52,527,1907,1645,262,332,1313
"381","2010",42017104000,42,17,6574,6240,54,10,123,0,38,109,81658,2403,2324,15,4,34,0,9,17,41,2362,2297,106,553,2561,2403,158,357,2046
"382","2010",42017104100,42,17,2158,1952,30,2,44,0,85,45,51528,902,836,11,2,19,0,25,9,56,846,811,91,364,959,902,57,479,423
"383","2010",42017104201,42,17,2793,2698,17,3,26,0,11,38,90625,1022,997,7,0,9,0,3,6,18,1004,983,39,226,1087,1022,65,124,898
"384","2010",42017104203,42,17,5336,4976,41,11,100,0,131,77,95991,1770,1677,13,4,27,0,32,17,67,1703,1645,125,333,1838,1770,68,260,1510
"385","2010",42017104204,42,17,4313,4029,26,2,87,2,106,61,81950,1498,1429,8,0,23,0,24,14,60,1438,1396,102,377,1540,1498,42,237,1261
"386","2010",42017104301,42,17,2908,2793,24,2,28,4,22,35,99563,1110,1083,8,1,7,0,5,6,17,1093,1071,39,272,1224,1110,114,122,988
"387","2010",42017104303,42,17,4533,4208,47,2,206,1,23,46,97702,1847,1757,19,1,61,0,4,5,35,1812,1727,120,589,1972,1847,125,190,1657
"388","2010",42017104304,42,17,1251,1192,11,0,20,0,16,12,167766,504,485,5,0,9,0,3,2,10,494,479,25,126,551,504,47,45,459
"389","2010",42017104400,42,17,2528,2355,27,3,47,0,58,38,83182,1258,1199,19,2,17,0,16,5,52,1206,1164,94,682,1398,1258,140,529,729
"390","2010",42017104502,42,17,7202,6586,109,6,369,0,29,103,85577,2711,2546,34,4,100,0,9,18,46,2665,2512,199,729,3022,2711,311,272,2439
"391","2010",42017104503,42,17,4382,4139,45,15,111,1,23,48,122431,1506,1451,13,3,22,0,7,10,24,1482,1431,75,266,1560,1506,54,125,1381
"392","2010",42017104505,42,17,5943,5637,51,5,177,0,11,62,144848,1887,1805,17,1,50,0,1,13,32,1855,1776,111,246,1922,1887,35,68,1819
"393","2010",42017104506,42,17,2548,2459,10,1,32,0,15,31,115179,879,862,4,0,7,0,3,3,21,858,843,36,161,929,879,50,68,811
"394","2010",42017104601,42,17,4766,4577,37,10,59,1,50,32,104219,1738,1692,10,4,15,1,8,8,27,1711,1674,64,319,1777,1738,39,89,1649
"395","2010",42017104603,42,17,6969,6383,315,13,98,4,44,112,103878,2116,2048,22,0,24,2,6,14,30,2086,2023,93,657,2212,2116,96,424,1692
"396","2010",42017104604,42,17,5824,5572,59,7,86,5,19,76,88056,2472,2397,19,3,22,2,5,24,35,2437,2372,100,908,2644,2472,172,624,1848
"397","2010",42017104701,42,17,3395,3197,33,1,100,0,6,58,46875,1801,1725,20,1,38,0,4,13,27,1774,1705,96,1081,1907,1801,106,1193,608
"398","2010",42017104702,42,17,2649,2497,53,3,29,5,17,45,88077,1177,1133,16,3,10,1,4,10,21,1156,1116,61,627,1249,1177,72,604,573
"399","2010",42017104703,42,17,2342,2258,20,7,29,0,6,22,91563,946,925,4,3,9,0,3,2,13,933,915,31,328,976,946,30,155,791
"400","2010",42017104800,42,17,3152,2971,50,6,41,6,43,35,80625,934,911,8,1,9,0,3,2,12,922,903,31,283,969,934,35,124,810
"401","2010",42017104901,42,17,7677,7089,109,23,338,4,28,86,147868,2424,2275,29,7,93,1,5,14,31,2393,2255,169,304,2465,2424,41,111,2313
"402","2010",42017104902,42,17,6760,6400,77,8,200,0,12,63,90208,2685,2582,32,2,55,0,1,13,38,2647,2547,138,699,2776,2685,91,171,2514
"403","2010",42017105003,42,17,4968,4747,26,8,153,1,6,27,102639,1668,1613,6,3,37,0,1,8,12,1656,1602,66,266,1727,1668,59,129,1539
"404","2010",42017105004,42,17,5595,5350,26,1,151,0,6,61,113750,1846,1784,7,0,43,0,3,9,18,1828,1769,77,212,1876,1846,30,52,1794
"405","2010",42017105006,42,17,5901,5601,30,1,217,0,8,44,126757,1944,1869,11,0,59,0,0,5,21,1923,1849,95,204,1962,1944,18,33,1911
"406","2010",42017105008,42,17,3610,3438,18,3,122,0,9,20,111738,1200,1159,3,2,32,0,1,3,15,1185,1144,56,171,1229,1200,29,48,1152
"407","2010",42017105009,42,17,3507,3358,35,2,78,0,3,31,71629,1611,1555,13,1,32,0,1,9,17,1594,1542,69,736,1727,1611,116,503,1108
"408","2010",42017105010,42,17,4009,3754,23,2,187,0,13,30,105135,1523,1445,8,1,59,0,5,5,17,1506,1431,92,337,1548,1523,25,137,1386
"409","2010",42017105011,42,17,3559,3318,27,0,164,0,9,41,104464,1299,1234,11,0,47,0,2,5,16,1283,1220,79,331,1325,1299,26,176,1123
"410","2010",42017105012,42,17,2673,2590,9,2,52,0,7,13,112568,925,908,2,0,11,0,2,2,8,917,902,23,134,947,925,22,30,895
"411","2010",42017105013,42,17,5904,5529,54,5,250,0,18,48,130781,1904,1810,16,0,70,0,3,5,16,1888,1797,107,198,1933,1904,29,33,1871
"412","2010",42017105100,42,17,2995,2830,41,4,83,0,13,24,98864,1036,992,11,1,24,0,4,4,11,1025,986,50,205,1088,1036,52,105,931
"413","2010",42017105202,42,17,5278,4846,82,0,278,1,17,54,95665,2275,2129,34,0,92,0,6,14,39,2236,2095,180,804,2334,2275,59,530,1745
"414","2010",42017105203,42,17,2044,1870,22,8,114,0,8,22,150372,721,669,8,2,33,0,1,8,12,709,659,62,138,734,721,13,64,657
"415","2010",42017105206,42,17,4835,4331,49,4,386,1,7,57,104779,1810,1670,16,1,104,1,2,16,17,1793,1656,154,424,1892,1810,82,194,1616
"416","2010",42017105207,42,17,4778,4158,64,5,475,0,21,55,115541,1865,1682,22,2,138,0,6,15,35,1830,1653,212,541,1923,1865,58,191,1674
"417","2010",42017105208,42,17,2364,2031,12,0,279,0,3,39,175078,723,642,6,0,69,0,0,6,11,712,631,92,60,735,723,12,25,698
"418","2010",42017105300,42,17,2248,2163,17,4,28,0,10,26,81103,965,943,5,2,7,0,3,5,15,950,931,34,366,1027,965,62,318,647
"419","2010",42017105400,42,17,8190,7758,94,13,207,0,37,81,163995,2965,2848,29,4,62,0,11,11,53,2912,2807,158,482,3100,2965,135,155,2810
"420","2010",42017105505,42,17,3981,3694,124,8,95,1,15,44,117454,1460,1389,35,2,22,0,3,9,29,1431,1364,96,308,1521,1460,61,214,1246
"421","2010",42017105506,42,17,4172,3656,78,0,365,3,23,47,156071,1287,1156,21,0,102,1,4,3,19,1268,1141,146,87,1302,1287,15,15,1272
"422","2010",42017105507,42,17,7224,6721,124,3,275,1,23,77,137157,2500,2369,39,1,72,1,5,13,35,2465,2339,161,343,2561,2500,61,41,2459
"423","2010",42017105508,42,17,3708,3334,40,0,278,0,7,49,185577,1125,1026,14,0,79,0,0,6,19,1106,1008,117,111,1140,1125,15,62,1063
"424","2010",42017105509,42,17,4534,4074,89,9,286,0,19,57,141484,1497,1374,29,2,79,0,2,11,27,1470,1350,147,193,1541,1497,44,40,1457
"425","2010",42017105510,42,17,4748,3977,195,8,448,3,35,82,78788,2473,2188,82,4,169,1,9,20,61,2412,2139,334,1201,2631,2473,158,937,1536
"426","2010",42017105511,42,17,4192,3705,103,5,312,0,15,52,129034,1463,1328,31,2,87,0,4,11,32,1431,1303,160,329,1488,1463,25,102,1361
"427","2010",42017105600,42,17,2434,2224,85,1,64,0,14,46,77171,1143,1066,38,1,21,0,7,10,24,1119,1052,91,498,1218,1143,75,340,803
"428","2010",42017105702,42,17,3143,2532,348,18,56,3,90,96,51447,1354,1155,130,7,14,1,28,19,89,1265,1103,251,566,1473,1354,119,587,767
"429","2010",42017105704,42,17,6210,4519,1119,10,132,0,265,165,55375,2611,1990,452,3,48,0,89,29,211,2400,1890,721,1000,2757,2611,146,1013,1598
"430","2010",42017105801,42,17,6346,4584,894,16,536,2,127,187,88938,2311,1667,378,9,161,1,50,45,116,2195,1618,693,580,2416,2311,105,937,1374
"431","2010",42017105805,42,17,5650,4935,292,7,188,0,76,152,49236,2406,2156,130,1,61,0,23,35,88,2318,2101,305,917,2531,2406,125,841,1565
"432","2010",42017105807,42,17,3445,2695,237,1,362,0,58,92,40469,1485,1221,112,0,106,0,21,25,47,1438,1199,286,577,1550,1485,65,706,779
"433","2010",42017105808,42,17,3507,3301,67,3,58,1,26,51,67005,1354,1294,25,1,17,0,8,9,31,1323,1270,84,395,1416,1354,62,97,1257
"434","2010",42017105809,42,17,4399,4033,112,9,127,0,43,75,71151,1528,1433,40,3,28,0,14,10,36,1492,1410,118,338,1568,1528,40,184,1344
"435","2010",42017105810,42,17,2320,2227,23,2,28,0,13,27,69583,863,842,7,1,6,0,2,5,15,848,830,33,258,880,863,17,151,712
"436","2010",42017105811,42,17,6276,5818,182,18,102,5,74,77,60350,2241,2092,65,8,39,1,21,15,64,2177,2052,189,581,2297,2241,56,508,1733
"437","2010",42017105812,42,17,1732,1638,45,2,14,0,11,22,78182,607,588,9,0,6,0,1,3,11,596,578,29,138,623,607,16,57,550
"438","2010",42017105900,42,17,1872,1770,59,4,7,0,11,21,45385,759,722,23,3,6,0,4,1,12,747,714,45,294,789,759,30,281,478
"439","2010",42017106000,42,17,4241,3865,105,6,153,0,34,78,74773,1697,1566,41,4,54,0,11,21,41,1656,1543,154,539,1757,1697,60,607,1090
"440","2010",42017106100,42,17,3064,2750,189,5,47,0,24,49,74375,964,905,39,2,7,0,2,9,10,954,898,66,381,1003,964,39,326,638
"441","2010",42017106200,42,17,7148,6557,200,6,174,2,111,98,61019,3130,2977,57,2,54,0,23,17,66,3064,2940,190,1206,3407,3130,277,1351,1779
"442","2010",42017106300,42,17,7069,6587,159,13,208,3,33,66,97179,2434,2294,60,4,52,1,8,15,37,2397,2269,165,466,2510,2434,76,492,1942
"443","2010",42017106401,42,17,7411,6703,113,27,288,1,135,144,78049,2577,2395,36,5,75,0,33,33,66,2511,2363,214,613,2670,2577,93,256,2321
"444","2010",42017106402,42,17,7347,6991,120,11,101,1,34,89,83105,2666,2587,31,3,23,0,6,16,33,2633,2563,103,626,2795,2666,129,340,2326
"445","2010",42017106500,42,17,6968,6598,80,8,89,1,83,109,62528,2721,2624,24,3,24,0,23,23,55,2666,2597,124,854,2843,2721,122,496,2225
"446","2010",42017106600,42,17,2012,1974,6,4,14,0,2,12,70938,832,818,1,3,4,0,1,5,11,821,808,24,260,930,832,98,155,677
"447","2010",42017980000,42,17,0,0,0,0,0,0,0,0,NA,0,0,0,0,0,0,0,0,0,0,0,0,0,0,0,0,0,0
"448","2010",42045400301,42,45,6674,1333,4447,15,363,10,211,295,29711,2437,634,1544,7,118,2,53,79,118,2319,602,1835,753,2655,2437,218,1388,1049
"449","2010",42045400302,42,45,4103,979,2698,12,173,1,83,157,41711,1358,422,833,3,50,1,20,29,52,1306,407,951,332,1479,1358,121,584,774
"450","2010",42045400401,42,45,5026,993,2385,28,1243,5,175,197,28020,1784,449,874,5,349,2,47,58,106,1678,403,1381,593,1988,1784,204,894,890
"451","2010",42045400402,42,45,4608,996,2620,8,639,3,179,163,33136,1712,485,949,3,182,1,48,44,102,1610,456,1256,635,1859,1712,147,925,787
"452","2010",42045400500,42,45,4235,1832,1522,2,553,0,182,144,42294,1574,783,556,0,155,0,50,30,97,1477,747,827,587,1681,1574,107,613,961
"453","2010",42045400600,42,45,5316,3413,1015,15,601,4,99,169,63125,2074,1468,365,2,168,2,29,40,64,2010,1442,632,796,2180,2074,106,703,1371
"454","2010",42045400700,42,45,5384,1805,1910,12,1301,3,183,170,62250,1728,753,588,2,309,1,41,34,83,1645,724,1004,425,1822,1728,94,498,1230
"455","2010",42045400801,42,45,2010,280,1407,6,219,0,37,61,44438,1067,170,765,2,96,0,13,21,25,1042,167,900,593,1362,1067,295,966,101
"456","2010",42045400802,42,45,3493,2501,645,4,201,6,47,89,55114,1322,1006,225,2,58,2,13,16,31,1291,991,331,451,1392,1322,70,363,959
"457","2010",42045400900,42,45,1584,1410,100,1,50,0,8,15,120722,569,523,28,0,15,0,1,2,7,562,517,52,116,584,569,15,40,529
"458","2010",42045401000,42,45,1934,1717,132,1,49,0,19,16,78295,725,646,50,1,18,0,6,4,11,714,641,84,234,773,725,48,224,501
"459","2010",42045401101,42,45,2924,2629,173,2,40,1,20,59,50750,1214,1120,66,1,13,0,6,8,19,1195,1109,105,468,1281,1214,67,298,916
"460","2010",42045401103,42,45,3503,3134,213,3,98,0,11,44,95125,1202,1102,64,1,27,0,3,5,19,1183,1088,114,316,1272,1202,70,264,938
"461","2010",42045401104,42,45,4134,3732,234,6,87,0,22,53,64145,1629,1496,84,2,27,0,7,13,28,1601,1482,147,530,1723,1629,94,281,1348
"462","2010",42045401200,42,45,3636,3358,131,4,106,0,6,31,64833,1550,1461,47,2,29,0,4,7,20,1530,1448,102,618,1637,1550,87,478,1072
"463","2010",42045401301,42,45,1621,942,215,2,408,0,16,38,48171,872,588,117,1,145,0,7,14,27,845,572,300,510,1066,872,194,861,11
"464","2010",42045401302,42,45,3032,2679,203,3,103,1,14,29,67500,1170,1057,69,1,31,1,4,7,25,1145,1037,133,378,1245,1170,75,301,869
"465","2010",42045401401,42,45,2114,1735,199,4,98,0,17,61,61678,847,716,77,1,31,0,9,13,21,826,706,141,293,883,847,36,168,679
"466","2010",42045401402,42,45,3947,3080,535,9,151,0,45,127,65924,1708,1425,204,4,42,0,12,21,35,1673,1407,301,722,1806,1708,98,751,957
"467","2010",42045401501,42,45,3469,3307,67,4,36,0,2,53,59918,1409,1361,24,1,10,0,0,13,8,1401,1354,55,453,1441,1409,32,198,1211
"468","2010",42045401502,42,45,4307,3061,646,15,471,1,16,97,54320,1844,1331,296,5,181,1,7,23,34,1810,1311,533,744,1967,1844,123,1003,841
"469","2010",42045401600,42,45,1824,1180,462,1,117,0,9,55,69681,785,507,215,0,47,0,3,13,11,774,501,284,311,823,785,38,306,479
"470","2010",42045401700,42,45,2668,815,1490,3,234,6,36,84,54524,923,361,470,1,61,1,10,19,35,888,351,572,287,1025,923,102,305,618
"471","2010",42045401800,42,45,3684,1423,1897,10,147,1,30,176,59421,1429,678,651,5,39,0,11,45,39,1390,658,771,489,1591,1429,162,507,922
"472","2010",42045401900,42,45,4480,2485,1670,7,145,0,40,133,68448,1935,1189,659,1,44,0,12,30,55,1880,1161,774,772,2043,1935,108,524,1411
"473","2010",42045402000,42,45,2456,1097,1166,3,86,0,8,96,60139,1225,622,525,1,35,0,4,38,30,1195,610,615,661,1341,1225,116,620,605
"474","2010",42045402100,42,45,5813,464,5122,6,38,7,54,122,54050,2169,227,1871,4,11,2,14,40,26,2143,226,1943,626,2316,2169,147,354,1815
"475","2010",42045402200,42,45,2309,273,1927,9,31,0,7,62,47308,842,110,695,2,7,0,2,26,9,833,109,733,336,945,842,103,321,521
"476","2010",42045402300,42,45,3321,124,3092,11,19,0,13,62,37202,1513,76,1391,6,7,0,5,28,27,1486,72,1441,697,1624,1513,111,1006,507
"477","2010",42045402400,42,45,3459,317,3000,9,23,0,14,96,36920,1092,149,905,2,9,0,5,22,26,1066,147,945,309,1321,1092,229,613,479
"478","2010",42045402500,42,45,3582,406,2971,5,14,3,36,147,27534,1252,164,1035,3,3,1,11,35,19,1233,162,1090,416,1451,1252,199,654,598
"479","2010",42045402600,42,45,3646,1012,2457,12,37,0,17,111,40469,1023,282,700,5,10,0,4,22,19,1004,279,744,250,1116,1023,93,337,686
"480","2010",42045402700,42,45,2546,404,2040,1,19,1,16,65,41019,824,193,611,0,5,0,1,14,8,816,191,633,227,916,824,92,305,519
"481","2010",42045402800,42,45,5697,1859,3450,16,118,1,41,212,54121,2112,827,1185,7,37,1,11,44,49,2063,809,1303,681,2265,2112,153,633,1479
"482","2010",42045402900,42,45,3471,75,3262,7,4,1,18,104,35929,1352,33,1268,2,0,1,8,40,29,1323,29,1323,444,1449,1352,97,619,733
"483","2010",42045403001,42,45,3006,2919,22,2,20,0,5,38,54966,1242,1214,10,1,8,0,2,7,6,1236,1210,32,431,1279,1242,37,106,1136
"484","2010",42045403002,42,45,2787,2349,324,1,31,1,18,63,49583,1137,994,117,0,9,0,3,14,19,1118,982,155,390,1198,1137,61,241,896
"485","2010",42045403101,42,45,3433,2214,941,8,109,1,49,111,55341,1263,910,284,2,29,0,12,26,30,1233,901,362,413,1354,1263,91,404,859
"486","2010",42045403103,42,45,2855,1678,963,12,76,0,6,120,50089,1050,707,304,3,19,0,0,17,15,1035,699,351,323,1117,1050,67,300,750
"487","2010",42045403104,42,45,2498,1019,1288,6,67,0,14,104,37576,877,431,398,3,14,0,3,28,24,853,419,458,272,975,877,98,426,451
"488","2010",42045403200,42,45,4152,3168,769,6,108,0,16,85,66691,1731,1394,281,3,32,0,4,17,18,1713,1385,346,611,1824,1731,93,408,1323
"489","2010",42045403300,42,45,6652,5476,758,16,220,0,24,158,45638,2683,2278,308,9,60,0,6,22,33,2650,2263,420,1018,2849,2683,166,1040,1643
"490","2010",42045403401,42,45,3028,1918,879,10,103,1,38,79,49067,1170,790,310,4,35,1,12,18,37,1133,773,397,384,1251,1170,81,394,776
"491","2010",42045403402,42,45,3578,2514,836,10,87,2,52,77,57845,1291,968,268,2,26,1,15,11,36,1255,952,339,356,1349,1291,58,232,1059
"492","2010",42045403501,42,45,4273,3700,352,6,73,4,18,120,52847,1763,1494,182,4,38,1,6,38,33,1730,1475,288,731,1863,1763,100,730,1033
"493","2010",42045403502,42,45,2880,2518,253,4,52,0,4,49,51171,1195,1070,97,3,14,0,1,10,15,1180,1061,134,443,1242,1195,47,287,908
"494","2010",42045403601,42,45,3964,3731,75,3,90,0,24,41,60132,1553,1484,34,1,21,0,7,6,20,1533,1472,81,568,1632,1553,79,544,1009
"495","2010",42045403602,42,45,1926,1865,14,1,27,0,9,10,64559,684,669,4,1,5,0,2,3,4,680,667,17,167,702,684,18,38,646
"496","2010",42045403701,42,45,1763,1655,31,3,37,0,6,31,47740,686,652,14,1,12,0,0,7,6,680,648,38,241,767,686,81,217,469
"497","2010",42045403702,42,45,2328,2178,40,4,46,1,11,48,58406,999,951,12,4,13,0,6,13,13,986,942,57,417,1071,999,72,326,673
"498","2010",42045403800,42,45,6454,5977,192,12,119,1,36,117,65259,2519,2386,62,3,38,1,7,22,38,2481,2359,160,942,2703,2519,184,934,1585
"499","2010",42045403901,42,45,3391,3178,100,3,55,0,16,39,53132,1557,1475,52,0,18,0,6,6,23,1534,1458,99,747,1671,1557,114,780,777
"500","2010",42045403902,42,45,3611,3496,42,1,26,1,7,38,67212,1408,1377,12,0,8,1,2,8,6,1402,1373,35,374,1491,1408,83,197,1211
"501","2010",42045404003,42,45,2147,1637,270,3,169,0,21,47,58417,1036,795,143,2,69,0,10,17,19,1017,786,250,554,1101,1036,65,603,433
"502","2010",42045404004,42,45,6514,6182,97,6,143,2,32,52,66604,2394,2311,29,1,36,1,9,7,26,2368,2293,101,611,2490,2394,96,320,2074
"503","2010",42045404101,42,45,6484,5703,582,15,88,0,24,72,52917,2593,2298,236,3,33,0,8,15,34,2559,2274,319,835,2665,2593,72,735,1858
"504","2010",42045404102,42,45,4833,4043,552,2,72,0,39,125,55625,1899,1621,213,0,24,0,15,26,42,1857,1603,296,646,2139,1899,240,591,1308
"505","2010",42045404103,42,45,3322,3167,43,0,67,0,4,41,60455,1338,1280,23,0,23,0,0,12,6,1332,1275,63,482,1384,1338,46,322,1016
"506","2010",42045404300,42,45,2410,1992,282,3,32,0,25,76,44375,926,811,84,2,7,0,7,15,23,903,800,126,316,1010,926,84,392,534
"507","2010",42045404400,42,45,1615,628,888,5,20,0,25,49,25313,654,278,340,1,9,0,8,18,27,627,265,389,289,697,654,43,310,344
"508","2010",42045404500,42,45,4991,999,3593,15,45,5,202,132,32522,1838,478,1236,6,16,1,66,35,167,1671,420,1418,739,2059,1838,221,1216,622
"509","2010",42045404600,42,45,2493,398,1918,13,5,1,61,97,35563,875,184,638,5,1,0,20,27,45,830,175,700,261,976,875,101,449,426
"510","2010",42045404700,42,45,3655,1852,1516,4,56,2,106,119,28071,950,327,555,1,13,0,33,21,60,890,316,634,561,1043,950,93,724,226
"511","2010",42045404800,42,45,2136,317,1542,16,12,0,163,86,29116,690,125,492,5,2,0,48,18,104,586,95,595,187,842,690,152,415,275
"512","2010",42045404900,42,45,1439,125,1096,2,7,0,118,91,35461,435,41,336,0,2,0,36,20,61,374,28,407,117,527,435,92,276,159
"513","2010",42045405000,42,45,2130,178,1791,12,18,0,74,57,29679,752,52,653,2,5,0,23,17,51,701,37,715,301,887,752,135,430,322
"514","2010",42045405100,42,45,2165,27,2087,2,4,0,12,33,30815,880,11,855,1,1,0,3,9,13,867,10,870,308,1006,880,126,447,433
"515","2010",42045405200,42,45,3030,51,2876,7,3,0,43,50,27122,1308,26,1255,3,1,0,12,11,36,1272,18,1290,547,1415,1308,107,880,428
"516","2010",42045405300,42,45,2610,313,2012,11,16,7,146,105,35550,900,111,716,6,6,1,38,22,97,803,82,818,292,1192,900,292,524,376
"517","2010",42045405400,42,45,2429,294,1911,14,15,5,79,111,20273,889,129,698,4,4,1,23,30,62,827,107,782,298,1099,889,210,563,326
"518","2010",42045406100,42,45,2328,1873,301,18,57,0,22,57,48750,876,732,103,4,15,0,5,17,23,853,719,157,290,912,876,36,189,687
"519","2010",42045406201,42,45,3036,2819,110,2,55,0,11,39,58780,1248,1173,43,0,21,0,3,8,17,1231,1161,87,392,1298,1248,50,95,1153
"520","2010",42045406202,42,45,4970,4575,189,4,97,0,14,91,63438,2287,2123,94,0,39,0,5,26,35,2252,2102,185,1010,2392,2287,105,440,1847
"521","2010",42045406300,42,45,3239,1663,1338,11,25,2,78,122,38938,1207,745,408,8,9,0,15,22,39,1168,736,471,427,1291,1207,84,657,550
"522","2010",42045406401,42,45,2855,425,2282,4,18,0,31,95,59896,939,187,707,2,8,0,11,24,27,912,179,760,226,1023,939,84,369,570
"523","2010",42045406402,42,45,1085,241,802,3,1,0,14,24,44107,472,127,335,2,0,0,3,5,11,461,123,349,200,542,472,70,199,273
"524","2010",42045406500,42,45,1828,1396,345,6,10,0,31,40,40435,625,518,90,2,4,0,9,2,22,603,508,117,159,667,625,42,171,454
"525","2010",42045406600,42,45,2397,1972,326,2,2,1,8,86,41016,907,788,111,0,1,0,2,5,16,891,779,128,333,1018,907,111,464,443
"526","2010",42045406700,42,45,3469,3039,274,4,20,0,19,113,50931,1247,1126,89,2,9,0,6,15,33,1214,1105,142,361,1346,1247,99,402,845
"527","2010",42045406801,42,45,4295,3512,525,10,125,1,41,81,71343,1685,1394,217,2,46,0,11,15,28,1657,1379,306,560,1774,1685,89,382,1303
"528","2010",42045406802,42,45,4332,3579,618,11,33,0,17,74,54034,1652,1381,240,5,8,0,6,12,33,1619,1355,297,507,1770,1652,118,368,1284
"529","2010",42045406803,42,45,8111,6972,645,23,296,0,31,144,67077,3347,2932,277,12,87,0,9,30,62,3285,2887,460,1206,3569,3347,222,1139,2208
"530","2010",42045406902,42,45,5866,5645,99,7,48,1,21,45,80009,2190,2117,39,3,15,1,6,9,28,2162,2097,93,562,2255,2190,65,174,2016
"531","2010",42045406903,42,45,5030,4888,54,4,42,0,7,35,85167,1849,1808,15,2,10,0,3,11,16,1833,1797,52,448,1875,1849,26,219,1630
"532","2010",42045406904,42,45,5696,5119,317,7,173,0,14,66,79356,1906,1812,31,1,55,0,0,7,15,1891,1800,106,707,1961,1906,55,195,1711
"533","2010",42045407000,42,45,2531,2330,84,1,81,0,5,30,75426,1157,1109,16,0,27,0,0,5,7,1150,1105,52,504,1263,1157,106,348,809
"534","2010",42045407101,42,45,3713,3380,88,2,174,0,28,41,105994,1513,1414,37,0,47,0,7,8,21,1492,1398,115,510,1559,1513,46,403,1110
"535","2010",42045407102,42,45,3169,3023,46,1,59,0,11,29,99188,1132,1089,17,1,18,0,1,6,13,1119,1076,56,241,1157,1132,25,38,1094
"536","2010",42045407201,42,45,5135,4711,218,10,119,0,33,44,84453,1792,1714,30,4,37,0,3,4,20,1772,1697,95,737,1924,1792,132,572,1220
"537","2010",42045407202,42,45,3790,3476,180,4,85,5,15,25,64267,1289,1230,26,2,26,0,1,4,9,1280,1224,65,514,1372,1289,83,427,862
"538","2010",42045407401,42,45,4057,3206,575,1,170,4,19,82,116212,1495,1242,188,1,42,1,7,14,22,1473,1231,264,350,1548,1495,53,302,1193
"539","2010",42045407404,42,45,2843,2587,81,5,119,0,6,45,102841,1097,1029,27,3,32,0,3,3,11,1086,1021,76,296,1125,1097,28,60,1037
"540","2010",42045407501,42,45,2340,2090,151,1,49,0,4,45,75605,1181,1077,71,1,18,0,2,12,16,1165,1062,119,633,1262,1181,81,442,739
"541","2010",42045407502,42,45,2987,2355,413,0,137,1,24,57,50944,1583,1312,176,0,66,1,12,16,41,1542,1284,299,1034,1719,1583,136,1176,407
"542","2010",42045407600,42,45,6390,5300,309,17,480,4,44,236,107056,2076,1854,90,4,99,0,6,23,38,2038,1826,250,703,2203,2076,127,574,1502
"543","2010",42045407700,42,45,2669,1737,677,7,161,0,16,71,57768,1130,802,265,3,39,0,4,17,16,1114,795,335,459,1215,1130,85,517,613
"544","2010",42045407801,42,45,4485,4229,60,2,157,1,13,23,84052,1696,1630,23,1,38,0,1,3,8,1688,1625,71,494,1727,1696,31,214,1482
"545","2010",42045407802,42,45,6353,5873,109,5,317,1,13,35,104393,2214,2080,30,3,90,0,2,9,20,2194,2063,151,408,2262,2214,48,185,2029
"546","2010",42045407803,42,45,5365,5072,82,2,153,0,6,50,97760,1928,1854,20,0,43,0,1,10,17,1911,1839,89,420,1973,1928,45,162,1766
"547","2010",42045407804,42,45,4506,4325,35,6,98,0,10,32,102520,1571,1523,11,2,28,0,1,6,13,1558,1511,60,309,1607,1571,36,81,1490
"548","2010",42045407805,42,45,1696,1561,41,0,69,0,0,25,81477,569,535,11,0,17,0,0,6,2,567,533,36,94,585,569,16,42,527
"549","2010",42045407806,42,45,1610,1375,86,4,113,0,4,28,74107,618,545,23,4,37,0,2,7,9,609,540,78,166,643,618,25,66,552
"550","2010",42045407901,42,45,3944,3707,52,1,123,3,10,48,135947,1407,1343,14,0,39,0,1,10,13,1394,1332,75,227,1450,1407,43,34,1373
"551","2010",42045407902,42,45,2760,2470,113,1,115,0,16,45,80000,1234,1120,49,1,45,0,6,13,19,1215,1106,128,513,1293,1234,59,442,792
"552","2010",42045407903,42,45,3438,2928,232,3,198,1,13,63,85483,1496,1291,103,1,82,1,3,15,17,1479,1280,216,606,1620,1496,124,595,901
"553","2010",42045408001,42,45,6170,5624,41,5,418,0,11,71,86544,2264,2124,15,1,113,0,2,9,16,2248,2109,155,517,2329,2264,65,200,2064
"554","2010",42045408002,42,45,4094,3681,79,3,284,0,5,42,88173,1609,1480,23,2,90,0,1,13,14,1595,1471,138,515,1708,1609,99,247,1362
"555","2010",42045408101,42,45,5320,4795,182,5,289,1,18,30,67576,1762,1640,29,3,79,0,5,6,16,1746,1630,132,400,1801,1762,39,188,1574
"556","2010",42045408102,42,45,3413,3056,38,0,286,0,16,17,68571,1323,1215,12,0,83,0,7,6,17,1306,1205,118,353,1365,1323,42,174,1149
"557","2010",42045408103,42,45,4431,3833,157,2,373,0,11,55,69034,1684,1504,53,1,113,0,1,12,16,1668,1491,193,498,1737,1684,53,518,1166
"558","2010",42045408300,42,45,4815,4084,315,4,198,0,72,142,120492,1399,1251,92,0,36,0,5,15,28,1371,1230,169,520,1464,1399,65,331,1068
"559","2010",42045408400,42,45,1850,1722,33,0,73,0,2,20,140167,865,830,12,0,20,0,1,2,3,862,827,38,431,943,865,78,348,517
"560","2010",42045408500,42,45,3997,3476,76,8,370,0,23,44,81545,1529,1356,33,4,116,0,11,9,21,1508,1344,185,407,1577,1529,48,286,1243
"561","2010",42045408600,42,45,3543,3332,55,1,107,0,5,43,87361,1329,1267,20,1,34,0,2,5,14,1315,1254,75,341,1351,1329,22,195,1134
"562","2010",42045408700,42,45,4871,4567,109,6,122,0,17,50,110092,1780,1688,37,2,41,0,4,8,21,1759,1673,107,451,1821,1780,41,264,1516
"563","2010",42045408800,42,45,4780,4254,243,3,175,0,30,75,83345,2002,1830,95,0,54,0,10,13,30,1972,1807,195,731,2089,2002,87,306,1696
"564","2010",42045408900,42,45,2933,2716,63,1,111,1,9,32,110625,1047,982,20,0,36,0,1,8,9,1038,975,72,219,1075,1047,28,43,1004
"565","2010",42045409000,42,45,3721,3357,99,2,209,0,11,43,88191,1346,1249,30,1,55,0,2,9,15,1331,1237,109,330,1374,1346,28,209,1137
"566","2010",42045409100,42,45,4180,3973,42,5,102,0,12,46,89375,1466,1413,11,1,27,0,4,10,16,1450,1402,64,348,1505,1466,39,175,1291
"567","2010",42045409200,42,45,4048,3808,66,5,113,0,12,44,81458,1473,1412,21,2,29,0,2,7,20,1453,1396,77,345,1511,1473,38,111,1362
"568","2010",42045409300,42,45,2354,2172,37,4,99,0,11,31,82857,888,827,14,2,33,0,5,7,17,871,812,76,252,909,888,21,129,759
"569","2010",42045409400,42,45,2861,2573,78,2,179,1,8,20,84615,994,924,17,1,46,0,4,2,8,986,920,74,233,1018,994,24,116,878
"570","2010",42045409500,42,45,4538,4211,77,2,190,0,7,51,81563,1666,1567,27,2,52,0,2,16,15,1651,1559,107,427,1713,1666,47,112,1554
"571","2010",42045409601,42,45,4585,3657,163,1,665,1,15,83,111848,1812,1553,54,0,193,0,0,12,18,1794,1535,277,661,2034,1812,222,646,1166
"572","2010",42045409602,42,45,4641,3865,249,3,403,0,37,84,62689,1650,1412,88,0,128,0,5,17,52,1598,1368,282,1041,1772,1650,122,1000,650
"573","2010",42045409701,42,45,7312,6377,201,3,566,0,48,117,177906,1953,1745,34,2,154,0,10,8,22,1931,1731,222,298,2050,1953,97,168,1785
"574","2010",42045409702,42,45,1918,1722,56,2,83,0,13,42,131875,169,157,5,0,4,0,0,3,1,168,156,13,51,175,169,6,16,153
"575","2010",42045409802,42,45,6168,5362,298,7,351,1,42,107,106450,1539,1405,22,0,94,0,2,16,35,1504,1375,164,564,1714,1539,175,581,958
"576","2010",42045409803,42,45,6907,6067,273,4,425,5,49,84,90323,2840,2552,102,0,143,3,17,23,69,2771,2502,338,1133,3069,2840,229,1063,1777
"577","2010",42045409902,42,45,4820,4509,54,4,207,0,13,33,96500,2076,1978,14,2,70,0,1,11,12,2064,1968,108,806,2293,2076,217,677,1399
"578","2010",42045409903,42,45,3823,3653,35,9,87,0,6,33,79518,1548,1499,10,4,28,0,0,7,9,1539,1490,58,517,1655,1548,107,257,1291
"579","2010",42045409904,42,45,3573,3395,22,3,112,1,9,31,123333,1247,1201,5,1,37,0,2,1,13,1234,1190,57,290,1317,1247,70,88,1159
"580","2010",42045410000,42,45,3987,3737,45,2,151,0,10,42,114085,1655,1584,17,0,45,0,3,6,14,1641,1572,83,586,1808,1655,153,433,1222
"581","2010",42045410100,42,45,8028,5812,1651,19,327,1,89,129,118079,2114,1935,76,4,90,0,2,7,16,2098,1921,193,315,2197,2114,83,189,1925
"582","2010",42045410200,42,45,3640,3253,50,1,276,0,19,41,108869,1436,1330,21,0,73,0,4,8,26,1410,1311,125,414,1513,1436,77,168,1268
"583","2010",42045410301,42,45,8284,6787,1006,2,335,2,64,88,128289,2313,2166,41,1,89,0,2,14,22,2291,2149,164,476,2416,2313,103,230,2083
"584","2010",42045410302,42,45,8947,8045,184,10,548,0,44,116,73737,3880,3588,71,3,174,0,17,27,54,3826,3553,327,1549,4295,3880,415,1655,2225
"585","2010",42045410400,42,45,8791,7936,158,16,539,3,35,104,115063,2998,2767,61,4,144,1,3,18,29,2969,2744,254,511,3101,2998,103,95,2903
"586","2010",42045410500,42,45,5076,898,1005,15,2764,11,182,201,37524,1540,374,346,3,717,2,40,58,94,1446,334,1206,361,1630,1540,90,732,808
"587","2010",42045410601,42,45,3372,3207,43,1,56,1,18,46,70363,1290,1241,19,1,15,0,6,8,20,1270,1225,65,373,1344,1290,54,238,1052
"588","2010",42045410602,42,45,4880,4485,203,3,106,0,20,63,70781,1780,1644,90,0,27,0,4,15,17,1763,1634,146,449,1836,1780,56,220,1560
"589","2010",42045410700,42,45,5279,678,4163,20,16,0,296,106,23134,1491,95,1336,6,2,0,20,32,58,1433,82,1409,546,2002,1491,511,937,554
"590","2010",42045410800,42,45,7719,6792,316,8,443,2,15,143,94146,2892,2641,93,2,130,0,3,23,40,2852,2607,285,751,2999,2892,107,294,2598
"591","2010",42045980000,42,45,0,0,0,0,0,0,0,0,NA,0,0,0,0,0,0,0,0,0,0,0,0,0,0,0,0,0,0
"592","2010",42091200103,42,91,4140,3697,34,3,329,3,25,49,121941,1295,1194,5,1,83,1,4,7,18,1277,1182,113,155,1325,1295,30,32,1263
"593","2010",42091200104,42,91,4207,3886,16,4,257,1,11,32,95500,1474,1389,4,1,74,0,2,4,14,1460,1377,97,223,1506,1474,32,44,1430
"594","2010",42091200105,42,91,2778,2251,23,3,435,0,22,44,115556,914,791,8,0,104,0,3,8,9,905,785,129,134,947,914,33,103,811
"595","2010",42091200106,42,91,1857,1622,55,8,135,3,7,27,47875,865,792,16,3,45,1,1,7,6,859,788,77,374,997,865,132,420,445
"596","2010",42091200200,42,91,1375,1272,37,0,35,1,5,25,87083,428,409,4,0,10,0,1,4,3,425,407,21,112,453,428,25,132,296
"597","2010",42091200301,42,91,5739,4491,388,13,539,7,147,154,59722,2525,2031,200,5,199,2,48,40,95,2430,1989,536,1080,2878,2525,353,1389,1136
"598","2010",42091200305,42,91,2291,2219,17,5,14,0,18,18,64698,893,879,6,0,4,0,2,2,11,882,870,23,293,907,893,14,192,701
"599","2010",42091200306,42,91,3434,3226,68,0,40,4,55,41,73967,1378,1319,23,0,11,2,15,8,29,1349,1306,72,397,1421,1378,43,363,1015
"600","2010",42091200307,42,91,3063,2508,332,15,98,0,31,79,51172,1381,1181,132,6,32,0,9,21,28,1353,1167,214,639,1492,1381,111,754,627
"601","2010",42091200308,42,91,3983,3265,325,15,261,2,32,83,65183,1658,1403,138,3,84,2,11,17,45,1613,1376,282,664,1734,1658,76,728,930
"602","2010",42091200309,42,91,2660,2498,51,2,55,1,9,44,79531,960,922,18,1,12,0,3,4,14,946,914,46,210,973,960,13,75,885
"603","2010",42091200310,42,91,2845,2694,50,0,44,0,26,31,76759,1139,1090,23,0,14,0,7,5,16,1123,1081,58,361,1167,1139,28,233,906
"604","2010",42091200401,42,91,3259,3078,65,8,45,0,39,24,61282,1418,1359,23,1,15,0,11,9,29,1389,1343,75,589,1615,1418,197,576,842
"605","2010",42091200402,42,91,4101,3720,132,13,71,2,66,97,66250,1625,1513,50,4,19,2,21,16,61,1564,1481,144,521,1704,1625,79,506,1119
"606","2010",42091200501,42,91,4081,3800,68,4,127,7,27,48,90612,1345,1283,15,1,35,1,5,5,15,1330,1273,72,256,1360,1345,15,81,1264
"607","2010",42091200502,42,91,5420,4459,393,18,286,0,123,141,48088,2236,1895,172,8,85,0,40,36,101,2135,1840,396,855,2461,2236,225,1173,1063
"608","2010",42091200505,42,91,6905,5805,268,5,716,1,35,75,112991,2280,1922,108,1,222,0,11,16,40,2240,1891,389,563,2455,2280,175,592,1688
"609","2010",42091200506,42,91,4376,3878,141,3,301,0,22,31,102833,1464,1325,47,1,84,0,4,3,14,1450,1316,148,242,1482,1464,18,138,1326
"610","2010",42091200507,42,91,5365,4556,258,4,464,1,31,51,84966,2244,1971,102,3,153,1,5,9,36,2208,1940,304,819,2295,2244,51,382,1862
"611","2010",42091200602,42,91,7741,5418,421,6,1728,0,41,127,86177,3010,2255,170,4,539,0,10,32,52,2958,2217,793,933,3085,3010,75,403,2607
"612","2010",42091200603,42,91,3412,2831,187,2,326,0,19,47,106285,1234,1067,57,1,99,0,3,7,16,1218,1055,179,285,1259,1234,25,78,1156
"613","2010",42091200605,42,91,5706,4460,256,4,889,0,17,80,87950,2163,1819,91,1,232,0,4,16,26,2137,1797,366,660,2290,2163,127,167,1996
"614","2010",42091200606,42,91,3264,2636,116,4,439,0,19,50,90190,1215,1037,46,2,115,0,4,11,29,1186,1015,200,353,1233,1215,18,157,1058
"615","2010",42091200607,42,91,4667,3677,164,2,725,0,13,86,119500,1585,1296,67,0,208,0,2,12,23,1562,1276,309,291,1600,1585,15,44,1541
"616","2010",42091200703,42,91,4338,3375,108,15,748,2,27,63,92952,1581,1305,40,4,214,0,6,12,35,1546,1284,297,346,1640,1581,59,355,1226
"617","2010",42091200704,42,91,3455,2900,159,5,280,11,22,78,78235,1383,1208,64,2,81,2,8,18,29,1354,1187,196,456,1499,1383,116,529,854
"618","2010",42091200707,42,91,4037,2623,345,15,815,0,121,118,55938,1645,1200,139,6,241,0,29,30,80,1565,1162,483,634,1858,1645,213,903,742
"619","2010",42091200708,42,91,5419,4134,167,7,966,1,35,109,75938,1923,1587,58,1,250,1,11,15,43,1880,1562,361,445,2086,1923,163,325,1598
"620","2010",42091200800,42,91,3290,2190,136,4,773,1,89,97,67011,1267,954,49,1,211,0,21,31,60,1207,925,342,443,1333,1267,66,603,664
"621","2010",42091200901,42,91,4143,2901,226,15,780,5,88,128,50774,1553,1264,72,2,179,0,17,19,45,1508,1241,312,618,1648,1553,95,653,900
"622","2010",42091200902,42,91,1257,958,104,0,133,4,37,21,50205,533,443,41,0,37,1,8,3,28,505,427,106,236,571,533,38,261,272
"623","2010",42091200903,42,91,4152,2982,301,9,626,3,96,135,54599,1842,1453,132,3,193,1,28,32,68,1774,1419,423,841,2033,1842,191,1020,822
"624","2010",42091200906,42,91,1998,1518,94,0,323,0,21,42,52250,817,648,38,0,118,0,6,7,20,797,638,179,328,895,817,78,371,446
"625","2010",42091200907,42,91,2627,2392,106,3,75,0,16,35,68398,1062,989,36,2,21,0,4,10,26,1036,973,89,369,1117,1062,55,279,783
"626","2010",42091200908,42,91,2092,1597,122,12,221,10,55,75,52188,848,717,42,2,55,2,17,13,34,814,702,146,350,893,848,45,352,496
"627","2010",42091201003,42,91,4918,3830,242,3,712,6,43,82,82037,2123,1707,108,0,274,3,10,21,38,2085,1684,439,762,2229,2123,106,673,1450
"628","2010",42091201004,42,91,4956,3717,234,3,874,0,43,85,79600,2027,1659,94,2,240,0,11,21,35,1992,1634,393,738,2114,2027,87,667,1360
"629","2010",42091201005,42,91,3454,3043,112,0,230,0,22,47,112614,1195,1075,36,0,72,0,2,10,12,1183,1065,130,172,1214,1195,19,65,1130
"630","2010",42091201006,42,91,2224,2025,71,0,97,0,5,26,136087,892,823,31,0,35,0,1,2,2,890,822,70,163,930,892,38,40,852
"631","2010",42091201100,42,91,3229,2831,166,4,81,1,33,113,56953,1290,1181,58,1,18,1,12,19,33,1257,1162,128,444,1348,1290,58,382,908
"632","2010",42091201201,42,91,5867,4943,199,2,627,1,20,75,105861,2381,2078,72,1,213,0,7,10,26,2355,2059,322,725,2483,2381,102,669,1712
"633","2010",42091201203,42,91,3389,3124,79,1,133,1,5,46,81818,1365,1296,27,0,37,0,1,4,9,1356,1288,77,530,1415,1365,50,453,912
"634","2010",42091201204,42,91,2149,1516,507,3,51,0,20,52,70613,946,720,196,1,20,0,2,7,9,937,713,233,360,1008,946,62,133,813
"635","2010",42091201301,42,91,3357,2717,341,1,164,10,58,66,58567,1396,1183,121,1,55,3,12,21,46,1350,1156,240,605,1457,1396,61,646,750
"636","2010",42091201302,42,91,3060,2192,482,12,77,7,139,151,50882,1208,945,184,1,27,1,29,21,74,1134,906,302,475,1310,1208,102,556,652
"637","2010",42091201404,42,91,4953,4154,213,2,523,1,19,41,122857,1931,1681,77,1,161,1,3,7,15,1916,1669,262,614,2013,1931,82,573,1358
"638","2010",42091201406,42,91,4482,3726,333,0,351,0,17,55,110956,1537,1328,102,0,93,0,5,9,21,1516,1318,219,216,1560,1537,23,44,1493
"639","2010",42091201407,42,91,2594,1735,678,9,95,0,21,56,90133,904,622,239,3,23,0,5,12,11,893,619,285,176,930,904,26,98,806
"640","2010",42091201408,42,91,4345,3691,88,3,511,0,14,38,130179,1483,1285,36,0,155,0,5,2,14,1469,1273,210,225,1499,1483,16,69,1414
"641","2010",42091201409,42,91,4120,3586,92,2,364,1,17,58,130026,1480,1328,35,1,108,0,2,6,17,1463,1314,166,244,1508,1480,28,65,1415
"642","2010",42091201410,42,91,2519,2092,176,2,187,1,19,42,97988,1015,911,36,0,57,0,4,7,17,998,899,116,355,1053,1015,38,172,843
"643","2010",42091201411,42,91,2556,2234,115,4,140,0,13,50,87955,1047,942,45,3,44,0,3,10,17,1030,932,115,353,1086,1047,39,220,827
"644","2010",42091201501,42,91,3462,3035,70,0,311,1,14,31,75402,1487,1345,32,0,97,1,5,7,27,1460,1324,163,643,1598,1487,111,718,769
"645","2010",42091201502,42,91,1908,1725,34,2,87,0,23,37,154087,693,648,10,1,22,0,4,8,13,680,642,51,125,713,693,20,14,679
"646","2010",42091201603,42,91,4552,2409,1793,10,130,1,44,165,72581,1711,973,652,2,40,1,12,31,44,1667,949,762,466,1772,1711,61,225,1486
"647","2010",42091201604,42,91,3128,1928,961,5,97,1,42,94,70571,1124,734,328,1,30,0,11,20,43,1081,711,413,266,1151,1124,27,82,1042
"648","2010",42091201605,42,91,2980,2362,397,2,119,0,37,63,67868,1044,875,119,0,32,0,7,11,24,1020,864,180,256,1070,1044,26,59,985
"649","2010",42091201606,42,91,2200,1282,723,1,70,0,37,87,59940,844,531,265,1,18,0,11,18,25,819,519,325,286,885,844,41,295,549
"650","2010",42091201607,42,91,3468,2893,361,1,87,0,29,97,84817,1323,1129,135,0,29,0,4,26,35,1288,1103,220,378,1362,1323,39,213,1110
"651","2010",42091201608,42,91,4684,4168,206,5,231,0,15,59,91250,1798,1630,80,1,72,0,5,10,32,1766,1607,191,502,1886,1798,88,359,1439
"652","2010",42091201703,42,91,3114,2871,123,2,43,1,21,53,79167,1145,1084,38,0,12,0,5,6,17,1128,1071,74,289,1173,1145,28,98,1047
"653","2010",42091201704,42,91,3333,2638,530,4,49,0,27,85,66389,1227,1004,185,2,19,0,4,13,21,1206,993,234,374,1277,1227,50,242,985
"654","2010",42091201705,42,91,4403,3991,179,10,104,0,52,67,81450,1658,1508,83,6,41,0,9,11,33,1625,1489,169,496,1716,1658,58,427,1231
"655","2010",42091201706,42,91,4606,3623,503,8,316,0,53,103,78893,1734,1417,189,3,95,0,12,18,49,1685,1388,346,489,1779,1734,45,466,1268
"656","2010",42091201800,42,91,2779,2470,136,1,114,0,6,52,58711,1320,1216,55,1,38,0,1,9,13,1307,1209,111,613,1450,1320,130,505,815
"657","2010",42091201901,42,91,4725,4329,58,2,249,0,22,65,88092,1795,1687,20,1,69,0,5,13,28,1767,1667,128,422,1854,1795,59,124,1671
"658","2010",42091201902,42,91,5968,4359,776,4,679,4,54,92,70724,2479,1863,322,2,252,2,16,22,40,2439,1844,635,996,2683,2479,204,837,1642
"659","2010",42091202000,42,91,2543,2436,10,1,31,0,13,52,73162,1051,1016,4,1,13,0,5,12,15,1036,1006,45,413,1097,1051,46,361,690
"660","2010",42091202100,42,91,4422,3988,254,0,87,0,14,79,66695,2014,1832,125,0,28,0,4,25,40,1974,1799,215,931,2128,2014,114,673,1341
"661","2010",42091202201,42,91,4810,3577,715,2,357,0,50,109,80174,1798,1414,244,1,98,0,14,27,59,1739,1375,423,495,1885,1798,87,350,1448
"662","2010",42091202202,42,91,3006,1028,1205,1,647,3,56,66,98200,960,410,370,0,150,1,16,13,49,911,384,576,146,989,960,29,19,941
"663","2010",42091202301,42,91,4571,3630,512,4,301,0,24,100,115729,1935,1602,203,1,102,0,8,19,42,1893,1574,361,625,2068,1935,133,491,1444
"664","2010",42091202302,42,91,2100,1442,490,8,93,3,19,45,89236,923,688,183,2,34,1,6,9,22,901,673,250,325,985,923,62,106,817
"665","2010",42091202401,42,91,3554,179,2901,31,288,1,35,119,38948,1755,120,1424,12,129,1,21,48,55,1700,113,1642,864,1866,1755,111,1745,10
"666","2010",42091202402,42,91,4689,2181,1808,14,439,0,101,146,87083,1715,885,626,3,141,0,24,36,58,1657,864,851,410,1823,1715,108,364,1351
"667","2010",42091202500,42,91,5236,1983,2665,12,362,1,56,157,63438,2159,827,1118,5,148,0,13,48,68,2091,794,1365,1058,2351,2159,192,1171,988
"668","2010",42091202602,42,91,2624,2088,361,4,101,2,15,53,104476,1008,869,87,1,39,0,3,9,13,995,860,148,452,1131,1008,123,429,579
"669","2010",42091202603,42,91,3861,3268,354,9,134,1,23,72,94351,1312,1140,113,1,34,0,7,17,23,1289,1123,189,592,1374,1312,62,526,786
"670","2010",42091202604,42,91,2342,1740,415,4,103,4,26,50,87237,903,724,139,2,25,0,5,8,21,882,713,190,239,937,903,34,161,742
"671","2010",42091203000,42,91,3154,2658,209,0,223,2,15,47,111250,1072,926,56,0,76,1,6,7,13,1059,919,153,264,1204,1072,132,220,852
"672","2010",42091203103,42,91,2985,2768,62,3,116,0,9,27,120871,1019,962,20,1,30,0,2,4,12,1007,954,65,170,1063,1019,44,67,952
"673","2010",42091203104,42,91,4182,3950,88,4,85,1,3,51,101429,1692,1621,29,2,29,0,1,10,11,1681,1611,81,549,1751,1692,59,431,1261
"674","2010",42091203105,42,91,5385,4867,181,6,253,0,15,63,109680,2193,1994,84,1,94,0,5,15,29,2164,1972,221,710,2280,2193,87,385,1808
"675","2010",42091203106,42,91,1643,1484,64,2,57,0,16,20,82591,768,703,27,1,25,0,6,6,16,752,692,76,373,807,768,39,390,378
"676","2010",42091203203,42,91,4093,3099,300,1,547,2,60,84,117344,1539,1207,117,1,178,1,14,21,40,1499,1185,354,381,1612,1539,73,565,974
"677","2010",42091203204,42,91,6558,5273,247,3,931,2,22,80,101176,2710,2292,102,2,291,1,6,16,45,2665,2256,454,877,2905,2710,195,746,1964
"678","2010",42091203205,42,91,2211,1777,263,1,119,0,21,30,128611,790,659,91,0,32,0,3,5,13,777,650,140,154,823,790,33,87,703
"679","2010",42091203207,42,91,3255,2899,93,3,214,1,15,30,111932,1164,1061,36,2,59,0,3,3,17,1147,1046,118,225,1202,1164,38,160,1004
"680","2010",42091203208,42,91,2758,2402,79,2,238,1,15,21,123438,1259,1135,35,1,78,1,3,6,14,1245,1124,135,481,1395,1259,136,136,1123
"681","2010",42091203302,42,91,5907,5157,384,3,251,1,42,69,93873,2232,1991,140,1,77,1,8,14,39,2193,1964,268,541,2298,2232,66,145,2087
"682","2010",42091203303,42,91,4155,3255,462,10,308,1,54,65,73846,1848,1543,163,2,111,1,11,17,40,1808,1520,328,799,1939,1848,91,567,1281
"683","2010",42091203304,42,91,3528,2735,371,5,296,1,44,76,70991,1629,1306,165,1,121,0,15,21,36,1593,1283,346,700,1783,1629,154,726,903
"684","2010",42091203401,42,91,6153,5083,684,3,206,1,68,108,60256,2894,2452,318,2,77,1,20,24,65,2829,2412,482,1306,3006,2894,112,830,2064
"685","2010",42091203402,42,91,6189,5035,461,8,528,2,59,96,75246,2836,2352,214,6,212,2,17,33,57,2779,2316,520,1231,3114,2836,278,1016,1820
"686","2010",42091203403,42,91,3192,2824,195,0,82,8,18,65,59360,1652,1517,79,0,33,2,3,18,29,1623,1497,155,854,1725,1652,73,383,1269
"687","2010",42091203500,42,91,6077,2990,2191,17,118,6,535,220,56037,2475,1341,903,6,55,1,116,53,222,2253,1265,1210,1004,2656,2475,181,1150,1325
"688","2010",42091203601,42,91,3243,838,1641,28,54,0,491,191,40891,989,276,548,8,14,0,106,37,234,755,189,800,289,1111,989,122,605,384
"689","2010",42091203602,42,91,3763,2001,1265,11,47,3,223,213,60139,1363,817,433,3,15,1,50,44,119,1244,767,596,437,1446,1363,83,386,977
"690","2010",42091203700,42,91,1545,799,535,3,47,0,123,38,43819,425,226,138,0,18,0,33,10,64,361,204,221,172,474,425,49,226,199
"691","2010",42091203801,42,91,3709,1757,1025,5,99,0,609,214,43682,1277,753,332,2,28,0,123,39,190,1087,704,573,412,1385,1277,108,579,698
"692","2010",42091203803,42,91,5630,2112,1713,12,98,6,1369,320,48299,1879,890,595,5,36,1,288,64,462,1417,762,1117,709,2207,1879,328,1387,492
"693","2010",42091203804,42,91,3241,1232,1263,19,54,9,501,163,34210,1047,468,414,5,20,2,106,32,192,855,397,650,331,1196,1047,149,579,468
"694","2010",42091203901,42,91,3709,918,1649,44,19,8,982,89,34012,1050,260,550,8,4,1,205,22,338,712,159,891,372,1259,1050,209,842,208
"695","2010",42091203902,42,91,3536,1460,1097,11,183,2,654,129,31019,1458,692,465,7,108,0,153,33,298,1160,578,880,739,1686,1458,228,1240,218
"696","2010",42091204002,42,91,3285,2465,357,10,286,0,92,75,64318,1401,1100,157,3,104,0,24,13,45,1356,1082,319,535,1460,1401,59,585,816
"697","2010",42091204007,42,91,2257,1828,164,1,217,0,13,34,60556,956,793,73,0,72,0,2,16,16,940,782,174,401,1007,956,51,456,500
"698","2010",42091204008,42,91,2865,2550,85,2,156,2,14,56,73147,1190,1067,46,1,57,1,3,15,26,1164,1046,144,440,1214,1190,24,397,793
"699","2010",42091204009,42,91,1439,1247,83,0,82,0,1,26,63125,643,587,19,0,30,0,0,7,9,634,580,63,277,677,643,34,98,545
"700","2010",42091204010,42,91,2582,2336,95,1,122,0,8,20,107823,941,867,32,1,38,0,1,2,6,935,862,79,180,950,941,9,24,917
"701","2010",42091204101,42,91,4321,4054,108,8,46,0,40,65,65858,1979,1895,38,4,16,0,13,13,37,1942,1874,105,971,2102,1979,123,646,1333
"702","2010",42091204102,42,91,3512,2890,400,2,96,0,56,68,70909,1829,1578,159,1,53,0,21,17,52,1777,1551,278,1167,2584,1829,755,1002,827
"703","2010",42091204200,42,91,1320,1189,47,6,44,0,11,23,99000,587,544,19,3,12,0,2,7,14,573,532,55,277,658,587,71,166,421
"704","2010",42091204300,42,91,2434,2064,143,2,165,2,17,41,81875,1152,1016,61,0,62,0,4,9,24,1128,998,154,533,1322,1152,170,253,899
"705","2010",42091204400,42,91,3241,2927,92,5,148,0,10,59,131607,1194,1079,43,3,53,0,4,12,19,1175,1063,131,265,1250,1194,56,284,910
"706","2010",42091204500,42,91,4752,4383,120,2,168,0,17,62,159400,1450,1344,43,0,47,0,5,11,33,1417,1319,131,303,1519,1450,69,130,1320
"707","2010",42091204600,42,91,4612,4187,96,5,223,0,30,71,201537,1567,1456,25,1,70,0,9,6,23,1544,1438,129,246,1627,1567,60,71,1496
"708","2010",42091204701,42,91,2173,1958,57,2,113,0,18,25,118214,1068,993,22,0,42,0,5,6,10,1058,986,82,492,1137,1068,69,175,893
"709","2010",42091204702,42,91,3402,2977,92,2,238,1,22,70,120281,1296,1177,30,0,69,1,8,11,28,1268,1161,135,360,1345,1296,49,186,1110
"710","2010",42091204800,42,91,5020,4674,70,0,205,0,18,53,176944,1939,1856,16,0,57,0,2,8,12,1927,1845,94,490,2112,1939,173,263,1676
"711","2010",42091204900,42,91,5178,4626,225,0,218,3,23,83,184875,1765,1684,23,0,50,1,3,4,28,1737,1660,105,442,1904,1765,139,170,1595
"712","2010",42091205000,42,91,2517,1923,227,3,236,0,28,100,53750,757,635,72,2,32,0,3,13,25,732,615,142,385,837,757,80,368,389
"713","2010",42091205100,42,91,1853,1447,183,0,166,2,13,42,79539,687,598,28,0,48,0,3,10,17,670,584,103,377,759,687,72,433,254
"714","2010",42091205200,42,91,2848,2625,39,0,122,0,16,46,108125,1249,1166,22,0,43,0,5,13,24,1225,1145,104,520,1345,1249,96,330,919
"715","2010",42091205300,42,91,1867,1058,592,6,78,1,47,85,53926,891,577,243,1,35,0,13,22,32,859,558,333,536,988,891,97,559,332
"716","2010",42091205400,42,91,5990,5068,186,2,566,2,55,111,87781,2609,2263,94,0,209,1,17,25,77,2532,2212,397,1035,2790,2609,181,1136,1473
"717","2010",42091205501,42,91,3514,2566,672,8,132,8,41,87,55685,1618,1293,238,2,48,2,11,24,45,1573,1269,349,782,1806,1618,188,754,864
"718","2010",42091205502,42,91,3565,3158,70,0,268,0,11,58,144659,1317,1194,28,0,82,0,2,11,20,1297,1177,140,257,1356,1317,39,59,1258
"719","2010",42091205503,42,91,4827,3895,382,2,441,0,23,84,95893,1902,1640,105,0,138,0,3,16,29,1873,1616,286,590,1984,1902,82,160,1742
"720","2010",42091205600,42,91,4314,3899,83,2,191,3,15,121,81929,1884,1739,44,0,74,1,5,21,33,1851,1714,170,786,1995,1884,111,736,1148
"721","2010",42091205700,42,91,4554,3636,360,14,128,0,259,157,46350,2008,1683,171,7,44,0,72,31,165,1843,1601,407,966,2161,2008,153,1051,957
"722","2010",42091205801,42,91,2643,1561,149,5,851,0,24,53,57794,1579,1072,90,1,382,0,10,24,33,1546,1049,530,990,1739,1579,160,1160,419
"723","2010",42091205805,42,91,3070,2332,131,10,469,1,65,62,63818,1229,1007,46,1,146,1,17,11,34,1195,992,237,373,1280,1229,51,214,1015
"724","2010",42091205806,42,91,2050,1652,87,2,213,0,51,45,59631,847,725,31,1,74,0,9,7,18,829,716,131,303,903,847,56,313,534
"725","2010",42091205807,42,91,2248,1258,150,10,626,0,126,78,73920,1032,661,73,2,244,0,31,21,68,964,627,405,530,1237,1032,205,705,327
"726","2010",42091205808,42,91,5340,4143,254,11,806,0,19,107,102813,1896,1546,81,2,243,0,4,20,41,1855,1515,381,446,1942,1896,46,205,1691
"727","2010",42091205809,42,91,2811,2328,117,10,291,2,23,40,105208,989,855,35,5,82,0,4,8,18,971,842,147,185,1008,989,19,45,944
"728","2010",42091205903,42,91,2719,2375,108,3,166,0,12,55,123185,1013,911,41,2,50,0,2,7,16,997,898,115,208,1042,1013,29,37,976
"729","2010",42091205904,42,91,2141,1874,128,3,85,0,10,41,134286,929,834,54,2,30,0,2,7,13,916,823,106,282,973,929,44,65,864
"730","2010",42091205905,42,91,3436,2479,311,7,532,0,32,75,66112,1672,1282,135,2,210,0,17,26,57,1615,1250,422,927,1798,1672,126,1041,631
"731","2010",42091205906,42,91,1937,1592,116,2,145,4,35,43,88661,841,711,53,1,53,2,10,11,17,824,702,139,333,878,841,37,163,678
"732","2010",42091206004,42,91,6147,4485,1108,6,371,0,67,110,87692,1598,1388,75,3,102,0,11,19,48,1550,1356,242,448,1676,1598,78,528,1070
"733","2010",42091206005,42,91,4397,3922,95,4,281,0,61,34,81840,1540,1421,27,2,74,0,10,6,34,1506,1400,140,323,1584,1540,44,126,1414
"734","2010",42091206006,42,91,3032,2868,54,1,74,1,7,27,69306,1449,1384,24,0,30,0,2,9,11,1438,1377,72,635,1628,1449,179,465,984
"735","2010",42091206007,42,91,6068,4481,391,3,1056,1,57,79,91230,2191,1719,94,0,342,0,15,21,43,2148,1691,500,608,2300,2191,109,667,1524
"736","2010",42091206102,42,91,8290,6781,324,11,1000,0,32,142,110417,3214,2742,132,2,307,0,9,22,54,3160,2698,516,947,3319,3214,105,377,2837
"737","2010",42091206104,42,91,2940,2558,109,7,193,3,12,58,115313,981,871,34,1,61,1,2,11,16,965,859,122,198,1004,981,23,83,898
"738","2010",42091206105,42,91,5442,4852,167,2,335,0,14,72,142625,1470,1335,38,1,82,0,3,11,23,1447,1315,155,156,1496,1470,26,78,1392
"739","2010",42091206106,42,91,4547,4189,136,8,138,1,20,55,97688,1695,1588,50,1,43,0,3,10,24,1671,1570,125,424,1730,1695,35,216,1479
"740","2010",42091206201,42,91,2666,2377,135,7,53,0,30,64,45036,1249,1146,57,4,18,0,10,14,31,1218,1128,121,581,1343,1249,94,599,650
"741","2010",42091206202,42,91,2086,1884,106,4,27,0,16,49,58281,883,817,38,2,11,0,5,10,27,856,796,87,371,1008,883,125,465,418
"742","2010",42091206300,42,91,5089,4549,206,8,195,1,33,97,104896,1378,1284,40,1,39,0,7,7,24,1354,1267,111,420,1427,1378,49,378,1000
"743","2010",42091206400,42,91,3509,3130,113,9,157,1,29,70,75321,1353,1232,50,2,47,1,9,12,25,1328,1218,135,374,1407,1353,54,257,1096
"744","2010",42091206501,42,91,4182,3534,195,0,336,0,30,87,107188,1323,1139,63,0,96,0,10,15,28,1295,1120,203,215,1359,1323,36,97,1226
"745","2010",42091206502,42,91,4957,4513,177,3,137,0,21,106,97247,1696,1572,52,1,44,0,6,21,35,1661,1548,148,382,1748,1696,52,195,1501
"746","2010",42091206600,42,91,1385,1314,34,1,10,1,6,19,50479,635,604,17,1,4,0,3,6,11,624,597,38,326,697,635,62,239,396
"747","2010",42091206702,42,91,3403,961,2040,0,10,0,390,2,NA,5,5,0,0,0,0,0,0,0,5,5,0,2,6,5,1,1,4
"748","2010",42091206703,42,91,3700,3334,78,1,155,1,67,64,113607,1405,1315,23,0,44,1,13,9,28,1377,1301,104,364,1495,1405,90,181,1224
"749","2010",42091206704,42,91,6612,5992,153,6,332,1,28,100,106823,2327,2155,57,2,89,0,10,14,35,2292,2131,196,459,2444,2327,117,213,2114
"750","2010",42091206801,42,91,6825,5736,198,0,771,0,20,100,121330,2424,2125,62,0,222,0,4,11,29,2395,2101,323,587,2590,2424,166,418,2006
"751","2010",42091206802,42,91,2925,2576,73,1,229,2,15,29,95156,1133,1022,28,1,71,0,5,6,14,1119,1013,120,293,1184,1133,51,114,1019
"752","2010",42091206901,42,91,4438,3541,218,1,544,1,45,88,58625,1827,1509,92,1,189,1,11,24,47,1780,1476,351,683,1901,1827,74,860,967
"753","2010",42091206904,42,91,5407,4675,240,13,361,1,20,97,63245,2448,2197,99,5,122,1,5,19,37,2411,2170,278,956,2559,2448,111,837,1611
"754","2010",42091206905,42,91,4780,4058,180,4,447,0,26,65,95724,1762,1548,68,1,127,0,5,13,19,1743,1531,231,421,1801,1762,39,142,1620
"755","2010",42091206906,42,91,2953,2684,89,1,126,1,14,38,86932,1250,1157,36,0,39,0,6,12,18,1232,1148,102,423,1285,1250,35,190,1060
"756","2010",42091207001,42,91,7792,6955,271,6,400,2,58,100,107003,2674,2448,88,2,109,1,12,14,46,2628,2417,257,482,2777,2674,103,475,2199
"757","2010",42091207003,42,91,2897,2657,67,0,123,0,12,38,94449,1131,1046,30,0,44,0,3,8,17,1114,1035,96,355,1179,1131,48,421,710
"758","2010",42091207004,42,91,4270,3938,98,3,141,0,30,60,70536,1655,1555,40,1,40,0,9,10,34,1621,1532,123,503,1708,1655,53,445,1210
"759","2010",42091207101,42,91,5783,5385,67,9,193,5,29,95,83884,2039,1936,22,3,58,2,6,12,18,2021,1925,114,423,2106,2039,67,454,1585
"760","2010",42091207103,42,91,4095,3757,110,6,163,0,18,41,97651,1410,1333,30,3,37,0,4,3,15,1395,1321,89,225,1446,1410,36,111,1299
"761","2010",42091207104,42,91,3186,3039,36,7,79,1,8,16,64138,1212,1179,9,0,17,0,2,5,9,1203,1174,38,342,1249,1212,37,119,1093
"762","2010",42091207201,42,91,2502,2194,78,5,93,1,66,65,62500,969,877,29,3,25,1,22,12,64,905,839,130,299,1013,969,44,356,613
"763","2010",42091207202,42,91,4116,3471,90,12,217,1,220,105,55536,1672,1488,36,7,57,1,54,29,146,1526,1420,252,595,1743,1672,71,739,933
"764","2010",42091207300,42,91,2665,2265,93,1,156,4,87,59,75962,998,904,30,1,31,2,18,12,65,933,863,135,287,1056,998,58,370,628
"765","2010",42091207400,42,91,2504,2425,20,5,24,0,13,17,86875,888,870,7,4,4,0,1,2,7,881,865,23,167,923,888,35,92,796
"766","2010",42091207500,42,91,3299,3168,45,1,33,0,19,33,96859,1154,1127,9,0,7,0,5,6,14,1140,1118,36,216,1199,1154,45,141,1013
"767","2010",42091207600,42,91,3686,3589,41,7,8,0,10,31,71532,1489,1463,12,5,2,0,2,5,11,1478,1453,36,429,1580,1489,91,224,1265
"768","2010",42091207800,42,91,6464,6184,98,2,94,8,34,44,84272,2354,2298,23,1,18,3,6,5,25,2329,2284,70,472,2424,2354,70,191,2163
"769","2010",42091207900,42,91,2383,2297,33,0,16,0,5,32,55345,1100,1070,14,0,6,0,1,9,15,1085,1057,43,470,1141,1100,41,353,747
"770","2010",42091208000,42,91,3843,3458,78,3,201,3,47,53,62500,1286,1238,18,0,12,1,11,6,34,1252,1217,69,366,1317,1286,31,414,872
"771","2010",42091208100,42,91,2951,2766,67,4,29,1,28,56,59931,1117,1070,18,3,5,0,9,12,23,1094,1060,57,340,1173,1117,56,377,740
"772","2010",42091208201,42,91,2187,2149,5,0,8,1,3,21,77537,786,781,2,0,0,0,0,3,3,783,778,8,149,811,786,25,69,717
"773","2010",42091208203,42,91,4364,4175,62,6,47,0,13,61,64890,1655,1602,26,3,11,0,3,10,29,1626,1579,76,431,1731,1655,76,476,1179
"774","2010",42091208204,42,91,3644,3459,39,22,62,1,21,40,92936,1171,1131,12,3,18,0,4,3,9,1162,1124,47,172,1198,1171,27,92,1079
"775","2010",42091208301,42,91,2639,2555,19,1,18,0,5,41,81810,1014,1000,4,1,4,0,0,5,4,1010,996,18,234,1061,1014,47,89,925
"776","2010",42091208302,42,91,8300,7872,111,8,200,2,21,86,99673,2783,2670,43,4,49,0,3,14,36,2747,2646,137,392,2858,2783,75,120,2663
"777","2010",42091208400,42,91,3523,3384,54,5,22,5,17,36,85494,1379,1334,21,1,5,1,10,7,20,1359,1324,55,426,1450,1379,71,263,1116
"778","2010",42091208500,42,91,4840,4566,95,15,66,2,46,50,82963,1834,1754,34,5,24,0,10,7,35,1799,1733,101,477,1908,1834,74,216,1618
"779","2010",42091208601,42,91,6127,5699,144,8,188,3,12,73,92361,2214,2092,56,3,50,1,3,9,27,2187,2069,145,514,2305,2214,91,295,1919
"780","2010",42091208603,42,91,6479,5956,249,8,158,1,26,81,78955,2473,2309,93,2,52,0,3,14,22,2451,2291,182,727,2560,2473,87,417,2056
"781","2010",42091208604,42,91,5468,4888,218,6,229,1,40,86,81919,2205,1998,92,2,80,0,13,20,32,2173,1975,230,840,2334,2205,129,645,1560
"782","2010",42091208702,42,91,3469,3280,107,0,31,1,1,49,102716,1283,1229,35,0,14,1,0,4,19,1264,1214,69,251,1326,1283,43,67,1216
"783","2010",42091208703,42,91,3857,3554,166,6,56,3,20,52,82232,1516,1439,54,1,13,1,2,6,18,1498,1425,91,431,1573,1516,57,197,1319
"784","2010",42091208704,42,91,4733,3456,947,5,104,3,30,188,72683,1698,1325,310,2,32,1,4,24,51,1647,1293,405,491,1752,1698,54,497,1201
"785","2010",42091208801,42,91,1178,823,226,6,4,0,51,68,23250,520,400,82,3,3,0,16,16,33,487,389,131,271,602,520,82,368,152
"786","2010",42091208802,42,91,3225,2640,376,4,30,4,54,117,55705,1348,1162,128,3,8,1,21,25,45,1303,1145,203,549,1441,1348,93,541,807
"787","2010",42091208901,42,91,3537,2816,502,7,26,2,54,130,47830,1541,1310,174,3,7,0,21,26,59,1482,1285,256,636,1697,1541,156,582,959
"788","2010",42091208903,42,91,2991,1962,809,6,31,4,52,127,49917,1191,849,291,1,12,1,14,23,41,1150,831,360,416,1299,1191,108,426,765
"789","2010",42091208904,42,91,3297,1834,1027,22,36,2,177,199,28875,1379,875,382,7,13,1,61,40,146,1233,811,568,706,1633,1379,254,1071,308
"790","2010",42091208905,42,91,2586,2337,135,2,19,0,25,68,47708,1170,1083,58,0,4,0,7,18,37,1133,1062,108,462,1273,1170,103,273,897
"791","2010",42091208906,42,91,3931,2683,878,20,36,0,146,168,39615,1523,1151,301,4,12,0,39,16,88,1435,1117,406,568,1696,1523,173,598,925
"792","2010",42091209000,42,91,1632,1048,413,4,15,3,41,108,25500,649,456,149,1,2,1,21,19,57,592,433,216,211,679,649,30,310,339
"793","2010",42091209100,42,91,5315,4736,306,12,125,3,29,104,90320,1858,1697,95,5,30,2,7,22,35,1823,1677,181,372,1950,1858,92,181,1677
"794","2010",42091209201,42,91,1587,1373,138,7,18,0,10,41,64225,604,543,40,1,6,0,4,10,16,588,535,69,183,642,604,38,185,419
"795","2010",42091209202,42,91,2287,1949,229,4,6,1,25,73,44732,920,820,72,2,2,1,10,13,22,898,810,110,330,971,920,51,319,601
"796","2010",42091210100,42,91,3871,3451,187,4,114,0,45,70,81767,1494,1373,64,3,31,0,10,13,34,1460,1353,141,397,1528,1494,34,317,1177
"797","2010",42091210200,42,91,2786,2361,275,1,77,1,21,50,101389,1045,908,103,0,20,0,5,9,14,1031,901,144,218,1066,1045,21,31,1014
"798","2010",42091210300,42,91,3921,3501,271,4,97,0,8,40,103520,1507,1406,48,1,40,0,2,10,15,1492,1395,112,533,1585,1507,78,334,1173
"799","2010",42091210400,42,91,4597,3638,704,6,139,1,35,74,77659,1918,1589,258,3,41,0,8,19,29,1889,1569,349,763,2007,1918,89,553,1365
"800","2010",42091210500,42,91,4243,3284,720,10,116,0,25,88,89375,1586,1340,191,3,27,0,5,20,18,1568,1329,257,510,1635,1586,49,271,1315
"801","2010",42091210600,42,91,4097,3308,374,9,325,0,15,66,74063,1627,1380,118,1,114,0,3,11,23,1604,1363,264,540,1712,1627,85,438,1189
"802","2010",42091210700,42,91,5792,4849,152,8,697,0,14,72,114718,1991,1734,49,3,187,0,2,16,34,1957,1704,287,371,2039,1991,48,214,1777
"803","2010",42101000100,42,101,3478,2968,212,8,174,2,35,79,75505,2301,1980,150,7,104,1,17,42,76,2225,1930,371,1791,2696,2301,395,1483,818
"804","2010",42101000200,42,101,2937,711,295,3,1856,1,26,45,49928,1145,360,29,0,734,0,6,16,29,1116,340,805,620,1285,1145,140,781,364
"805","2010",42101000300,42,101,3169,2386,328,1,329,1,39,85,71250,1855,1384,234,1,175,1,21,39,79,1776,1327,528,1362,1968,1855,113,1402,453
"806","2010",42101000401,42,101,2125,1122,382,11,520,0,20,70,30000,1584,824,317,8,366,0,15,54,77,1507,772,812,1320,1790,1584,206,1240,344
"807","2010",42101000402,42,101,3142,2534,176,4,356,4,26,42,44805,2273,1884,101,4,241,2,17,24,63,2210,1840,433,1806,2709,2273,436,887,1386
"808","2010",42101000500,42,101,2329,959,899,12,341,2,56,60,45734,684,408,60,4,174,1,16,21,28,656,396,288,576,797,684,113,639,45
"809","2010",42101000600,42,101,1781,1232,265,1,162,0,48,73,62806,723,559,45,0,91,0,11,17,31,692,536,187,602,814,723,91,694,29
"810","2010",42101000700,42,101,3082,2205,287,6,468,0,33,83,38654,2176,1572,205,3,319,0,20,57,99,2077,1506,670,1832,2489,2176,313,1620,556
"811","2010",42101000801,42,101,1562,1289,49,4,169,4,13,34,83125,1017,849,34,0,109,1,7,17,50,967,808,209,758,1078,1017,61,723,294
"812","2010",42101000803,42,101,3601,2983,75,2,443,3,13,82,75219,2590,2151,54,1,326,2,10,46,86,2504,2089,501,2059,2844,2590,254,1623,967
"813","2010",42101000804,42,101,3609,2985,99,1,424,1,26,73,75357,2589,2123,78,1,314,1,22,50,111,2478,2035,554,2068,3066,2589,477,1976,613
"814","2010",42101000901,42,101,2276,1580,223,4,352,1,40,76,30781,1729,1210,160,4,278,1,24,52,66,1663,1170,559,1548,1877,1729,148,1557,172
"815","2010",42101000902,42,101,2773,1869,172,3,640,2,17,70,35425,1419,941,126,2,319,2,6,23,48,1371,908,511,1049,1582,1419,163,1189,230
"816","2010",42101001001,42,101,2603,2348,70,0,132,0,18,35,89659,1600,1464,42,0,69,0,8,17,42,1558,1430,170,1044,1733,1600,133,569,1031
"817","2010",42101001002,42,101,3612,3184,94,5,220,2,33,74,94044,2099,1884,47,2,117,1,17,31,64,2035,1840,259,1350,2348,2099,249,846,1253
"818","2010",42101001101,42,101,3586,2885,348,3,229,3,21,97,53409,2097,1737,186,1,133,1,6,33,73,2024,1673,424,1765,2263,2097,166,1440,657
"819","2010",42101001102,42,101,2659,2228,134,3,187,1,20,86,65214,1624,1400,73,0,109,1,8,33,50,1574,1365,259,1226,1741,1624,117,1060,564
"820","2010",42101001201,42,101,3778,3343,87,6,222,1,33,86,104093,2052,1833,49,1,121,1,15,32,66,1986,1787,265,1282,2193,2052,141,1006,1046
"821","2010",42101001202,42,101,5137,4330,291,9,321,3,45,138,65725,3131,2672,157,5,202,1,21,73,134,2997,2570,561,2418,3529,3131,398,2288,843
"822","2010",42101001300,42,101,4942,2886,1583,13,243,1,54,162,61143,2470,1524,751,5,117,1,18,54,71,2399,1475,995,1527,2868,2470,398,1082,1388
"823","2010",42101001400,42,101,3950,2499,1034,7,222,1,77,110,55273,2129,1362,586,5,100,1,28,47,83,2046,1316,813,1545,2373,2129,244,1286,843
"824","2010",42101001500,42,101,2708,1952,458,0,185,2,37,74,73571,1336,1015,200,0,76,0,22,23,68,1268,969,367,849,1545,1336,209,650,686
"825","2010",42101001600,42,101,2192,1871,113,3,95,2,28,80,63694,1162,1028,60,2,42,1,9,20,42,1120,1000,162,757,1294,1162,132,675,487
"826","2010",42101001700,42,101,2647,2282,163,4,97,1,39,61,86144,1392,1230,88,0,42,0,14,18,39,1353,1204,188,854,1498,1392,106,619,773
"827","2010",42101001800,42,101,2873,2022,559,2,174,0,42,74,67750,1382,1064,207,2,66,0,17,26,54,1328,1033,349,792,1628,1382,246,646,736
"828","2010",42101001900,42,101,2721,1345,1108,8,121,3,67,69,58589,1292,655,514,6,63,1,23,30,79,1213,618,674,833,1524,1292,232,619,673
"829","2010",42101002000,42,101,2092,132,1831,8,36,0,22,63,20272,861,56,763,3,13,0,8,18,22,839,52,809,388,1066,861,205,403,458
"830","2010",42101002100,42,101,2036,269,1630,7,12,1,52,65,31103,840,116,683,2,5,0,10,24,25,815,107,733,396,1090,840,250,357,483
"831","2010",42101002200,42,101,2281,597,1405,10,97,0,89,83,31277,1018,338,575,5,38,0,26,36,60,958,319,699,588,1270,1018,252,573,445
"832","2010",42101002300,42,101,2682,1847,128,3,383,1,257,63,33681,1232,956,61,2,123,0,65,25,104,1128,919,313,715,1348,1232,116,587,645
"833","2010",42101002400,42,101,5129,3230,453,55,814,4,432,141,43462,2273,1654,185,10,271,3,107,43,235,2038,1553,720,1268,2538,2273,265,1098,1175
"834","2010",42101002500,42,101,3769,1932,1350,10,268,2,96,111,32554,1669,964,536,4,95,0,31,39,96,1573,922,747,849,1818,1669,149,915,754
"835","2010",42101002701,42,101,3874,1330,885,32,1006,0,490,131,33779,1463,635,362,11,283,0,140,32,224,1239,574,889,705,1677,1463,214,855,608
"836","2010",42101002702,42,101,3566,3232,128,1,101,0,40,64,55764,1704,1582,48,1,39,0,11,23,58,1646,1538,166,933,1895,1704,191,617,1087
"837","2010",42101002801,42,101,4324,1677,349,44,1367,0,729,158,30842,1561,796,143,12,401,0,173,36,298,1263,701,860,681,1774,1561,213,816,745
"838","2010",42101002802,42,101,5539,3854,74,6,1075,1,415,114,44364,2269,1805,32,3,299,0,96,34,159,2110,1752,517,1072,2496,2269,227,834,1435
"839","2010",42101002900,42,101,4141,3495,106,2,306,0,106,126,44524,2047,1828,57,1,92,0,36,33,89,1958,1776,271,1172,2225,2047,178,771,1276
"840","2010",42101003001,42,101,4664,964,1024,11,2293,9,208,155,33951,1614,498,386,1,639,3,51,36,85,1529,473,1141,605,1803,1614,189,749,865
"841","2010",42101003002,42,101,3200,588,2007,17,330,1,164,93,23145,1320,290,840,8,108,0,43,31,72,1248,275,1045,649,1567,1320,247,710,610
"842","2010",42101003100,42,101,4437,220,3862,18,191,7,57,82,26681,1840,100,1629,4,61,2,18,26,40,1800,94,1746,779,2343,1840,503,871,969
"843","2010",42101003200,42,101,4875,207,4431,13,44,1,47,132,25347,1797,95,1636,5,11,1,14,35,29,1768,90,1707,638,2271,1797,474,837,960
"844","2010",42101003300,42,101,6162,1614,4073,21,235,0,72,147,24312,2295,738,1421,8,77,0,21,30,53,2242,725,1570,821,2761,2295,466,1171,1124
"845","2010",42101003600,42,101,6723,1475,4029,25,908,2,124,160,20326,2635,755,1536,9,247,2,38,48,97,2538,729,1906,971,2803,2635,168,1546,1089
"846","2010",42101003701,42,101,6609,591,4888,18,852,2,87,171,34391,2259,270,1657,6,248,1,26,51,66,2193,251,2008,695,2663,2259,404,1086,1173
"847","2010",42101003702,42,101,3707,1052,1752,5,698,1,74,125,34885,1350,516,597,2,194,0,19,22,47,1303,499,851,440,1486,1350,136,493,857
"848","2010",42101003800,42,101,3898,3539,72,7,196,0,33,51,54063,1645,1543,30,2,47,0,12,11,27,1618,1529,116,628,1723,1645,78,310,1335
"849","2010",42101003901,42,101,6062,4040,590,16,1104,4,166,142,34728,2674,2007,247,6,324,0,45,45,121,2553,1953,721,1336,2936,2674,262,1159,1515
"850","2010",42101003902,42,101,5507,5325,19,4,80,0,21,58,57449,2448,2386,9,3,24,0,6,20,31,2417,2368,80,995,2630,2448,182,491,1957
"851","2010",42101004001,42,101,4259,3380,98,13,517,6,139,106,37070,1915,1651,44,6,143,3,40,28,96,1819,1604,311,961,2091,1915,176,695,1220
"852","2010",42101004002,42,101,4998,4640,25,5,209,1,56,62,37205,2193,2094,7,2,62,0,13,15,42,2151,2068,125,885,2362,2193,169,546,1647
"853","2010",42101004101,42,101,6243,1767,1325,40,2097,9,737,268,22344,2146,820,519,11,564,2,163,67,299,1847,730,1416,804,2447,2146,301,1071,1075
"854","2010",42101004102,42,101,7848,3635,841,24,2375,11,680,282,34676,2688,1564,268,7,633,4,154,58,259,2429,1496,1192,892,2981,2688,293,1227,1461
"855","2010",42101004201,42,101,5105,4174,290,3,436,1,106,95,47110,2067,1780,105,2,123,1,28,28,82,1985,1734,333,797,2284,2067,217,550,1517
"856","2010",42101004202,42,101,4925,3881,258,9,544,2,91,140,43000,1800,1504,82,5,152,2,27,28,75,1725,1467,333,533,1925,1800,125,376,1424
"857","2010",42101005000,42,101,13,8,1,0,0,0,4,0,NA,1,0,0,0,0,0,1,0,1,0,0,1,0,1,1,0,1,0
"858","2010",42101005400,42,101,1314,167,1007,3,73,6,25,33,53200,628,94,476,3,32,2,7,14,21,607,90,538,303,689,628,61,391,237
"859","2010",42101005500,42,101,5635,750,4466,9,203,1,59,147,48323,2258,369,1757,5,64,1,17,45,54,2204,349,1909,820,2429,2258,171,696,1562
"860","2010",42101005600,42,101,1111,96,938,3,41,1,1,31,41447,542,62,451,1,15,0,0,13,12,530,55,487,251,587,542,45,454,88
"861","2010",42101006000,42,101,6450,1150,4620,28,416,0,114,122,40496,2427,613,1618,6,119,0,31,40,46,2381,602,1825,844,2617,2427,190,804,1623
"862","2010",42101006100,42,101,3123,414,2326,6,292,0,26,59,39715,1130,216,802,1,84,0,10,17,15,1115,215,915,318,1213,1130,83,242,888
"863","2010",42101006200,42,101,4524,427,3737,8,221,2,31,98,30833,1429,200,1126,2,64,1,12,24,32,1397,194,1235,328,1592,1429,163,484,945
"864","2010",42101006300,42,101,4236,253,3150,15,618,2,110,88,23214,1344,112,1003,5,165,1,34,24,51,1293,107,1237,457,1620,1344,276,824,520
"865","2010",42101006400,42,101,4472,342,3410,12,527,1,57,123,32125,1417,170,1077,2,127,1,14,26,39,1378,160,1257,383,1586,1417,169,530,887
"866","2010",42101006500,42,101,4486,33,4291,22,23,5,21,91,25833,1681,18,1620,9,7,1,4,22,21,1660,18,1663,592,2088,1681,407,710,971
"867","2010",42101006600,42,101,3750,199,2957,11,421,2,69,91,25158,1357,94,1079,5,125,1,24,29,43,1314,88,1269,574,1571,1357,214,844,513
"868","2010",42101006700,42,101,7472,794,5746,25,545,5,151,206,23815,2495,398,1833,7,160,3,36,58,76,2419,386,2109,703,2804,2495,309,1133,1362
"869","2010",42101006900,42,101,2539,61,2406,13,3,0,20,36,18125,996,28,937,4,2,0,6,19,20,976,27,969,327,1093,996,97,698,298
"870","2010",42101007000,42,101,3990,56,3807,9,29,1,20,68,28819,1475,32,1411,3,9,0,5,15,7,1468,32,1443,513,1715,1475,240,596,879
"871","2010",42101007101,42,101,2557,129,2326,7,23,0,10,62,32697,882,14,835,1,11,0,2,19,14,868,12,870,298,1093,882,211,425,457
"872","2010",42101007102,42,101,4924,32,4747,15,19,0,24,87,25444,1776,16,1715,4,7,0,8,26,22,1754,15,1761,545,2042,1776,266,620,1156
"873","2010",42101007200,42,101,4773,67,4530,19,41,0,23,93,29698,1730,29,1645,7,9,0,5,35,30,1700,27,1703,587,2040,1730,310,642,1088
"874","2010",42101007300,42,101,3088,192,2723,9,30,3,40,91,25662,1117,85,969,7,11,2,9,34,25,1092,80,1037,416,1351,1117,234,538,579
"875","2010",42101007400,42,101,4338,300,3821,8,62,0,60,87,22058,1667,125,1469,4,22,0,16,31,29,1638,122,1545,714,2031,1667,364,835,832
"876","2010",42101007700,42,101,2380,988,703,14,583,3,28,61,30536,775,299,273,7,170,3,8,15,12,763,295,480,560,899,775,124,637,138
"877","2010",42101007800,42,101,4177,2207,1510,13,245,1,38,163,38849,2017,1096,720,7,117,0,18,59,86,1931,1048,969,1401,2315,2017,298,1479,538
"878","2010",42101007900,42,101,4553,2249,1735,24,258,5,68,214,41343,2116,1109,792,8,100,5,22,80,101,2015,1053,1063,1271,2301,2116,185,1347,769
"879","2010",42101008000,42,101,3951,389,3331,12,46,1,50,122,30797,1549,174,1302,4,18,1,11,39,34,1515,167,1382,648,1909,1549,360,709,840
"880","2010",42101008101,42,101,2758,33,2635,8,12,0,15,55,26083,1025,15,973,4,6,0,5,22,18,1007,14,1011,343,1190,1025,165,365,660
"881","2010",42101008102,42,101,5028,40,4847,10,10,0,21,100,31763,1871,22,1799,6,5,0,6,33,26,1845,20,1851,599,2083,1871,212,570,1301
"882","2010",42101008200,42,101,6797,52,6512,16,44,3,44,126,37500,2609,19,2507,9,12,2,9,51,32,2577,15,2594,902,2928,2609,319,668,1941
"883","2010",42101008301,42,101,4081,119,3806,18,41,3,12,82,25846,1626,23,1541,6,22,2,3,29,20,1606,20,1606,757,1935,1626,309,702,924
"884","2010",42101008302,42,101,4307,31,4111,36,40,0,18,71,28000,1751,15,1672,15,12,0,7,30,38,1713,12,1739,671,2134,1751,383,766,985
"885","2010",42101008400,42,101,4488,49,4246,21,22,0,31,119,25911,1731,21,1651,8,5,0,10,36,29,1702,17,1714,624,2041,1731,310,710,1021
"886","2010",42101008500,42,101,6313,230,5762,51,88,8,45,129,28059,2605,99,2398,18,21,2,13,54,43,2562,91,2514,1119,3171,2605,566,1433,1172
"887","2010",42101008601,42,101,2947,1430,1076,20,293,1,28,99,37449,1416,716,516,10,112,0,17,45,57,1359,681,735,932,1637,1416,221,1081,335
"888","2010",42101008602,42,101,3010,328,2421,24,106,0,47,84,29472,1345,142,1104,10,35,0,18,36,44,1301,131,1214,712,1548,1345,203,1039,306
"889","2010",42101008701,42,101,4147,2148,673,16,1060,5,71,174,33880,1983,1107,343,4,411,3,32,83,94,1889,1061,922,1432,2116,1983,133,1724,259
"890","2010",42101008702,42,101,3036,1821,393,6,667,1,46,102,24808,1512,924,165,0,360,0,21,42,72,1440,883,629,1265,1598,1512,86,1372,140
"891","2010",42101008801,42,101,988,555,91,2,298,0,9,33,20543,184,84,9,0,85,0,1,5,10,174,77,107,165,190,184,6,184,0
"892","2010",42101008802,42,101,6983,3898,806,10,1890,4,67,308,10584,1798,980,175,7,536,2,22,76,97,1701,913,885,1616,1927,1798,129,1761,37
"893","2010",42101009000,42,101,5576,3937,444,16,956,2,75,146,20635,1413,947,145,7,256,0,19,39,44,1369,921,492,1212,1528,1413,115,1291,122
"894","2010",42101009100,42,101,2803,1140,1171,7,361,0,38,86,15119,1535,579,678,2,211,0,22,43,48,1487,565,970,1209,1746,1535,211,1313,222
"895","2010",42101009200,42,101,2884,345,2223,12,188,3,28,85,22264,1220,163,956,2,55,1,12,31,30,1190,157,1063,612,1488,1220,268,842,378
"896","2010",42101009300,42,101,4221,79,3974,21,27,1,32,87,23264,1711,32,1617,13,7,1,10,31,35,1676,28,1683,731,2217,1711,506,855,856
"897","2010",42101009400,42,101,3827,28,3687,9,8,0,21,74,19433,1724,16,1662,6,2,0,8,30,24,1700,14,1710,858,1984,1724,260,1138,586
"898","2010",42101009500,42,101,3313,18,3180,23,4,2,22,64,17384,1299,6,1250,9,1,2,6,25,17,1282,6,1293,504,1587,1299,288,654,645
"899","2010",42101009600,42,101,4238,78,4000,20,27,0,13,100,20777,1686,33,1590,8,15,0,5,35,23,1663,28,1658,635,2059,1686,373,803,883
"900","2010",42101009801,42,101,2184,250,1807,4,41,0,22,60,37361,886,139,710,0,17,0,5,15,11,875,133,753,309,976,886,90,305,581
"901","2010",42101009802,42,101,5475,622,4605,6,104,3,29,106,50769,2169,353,1738,4,35,1,7,31,42,2127,336,1833,684,2261,2169,92,529,1640
"902","2010",42101010000,42,101,4366,488,3665,25,63,3,61,61,39474,1636,250,1311,12,14,1,20,28,48,1588,237,1399,589,1804,1636,168,570,1066
"903","2010",42101010100,42,101,5459,109,5149,24,39,0,42,96,25764,2209,49,2091,12,9,0,9,39,33,2176,42,2167,891,2643,2209,434,889,1320
"904","2010",42101010200,42,101,3187,21,3075,19,7,1,15,49,16622,1281,11,1237,6,2,0,2,23,12,1269,10,1271,523,1485,1281,204,726,555
"905","2010",42101010300,42,101,2449,20,2331,9,14,0,11,64,27321,964,8,924,5,5,0,2,20,19,945,5,959,374,1200,964,236,472,492
"906","2010",42101010400,42,101,3332,96,3125,11,6,0,36,58,34432,1171,17,1121,4,0,0,11,18,14,1157,15,1156,462,1477,1171,306,598,573
"907","2010",42101010500,42,101,3746,105,3493,19,20,0,30,79,16445,1489,23,1422,7,4,0,12,21,28,1461,21,1468,777,1666,1489,177,1054,435
"908","2010",42101010600,42,101,1476,42,1331,4,35,0,11,53,19770,666,20,611,3,10,0,5,17,9,657,18,648,374,816,666,150,462,204
"909","2010",42101010700,42,101,3562,78,3388,19,10,0,24,43,20292,1330,27,1261,10,4,0,10,18,26,1304,23,1307,584,1702,1330,372,890,440
"910","2010",42101010800,42,101,3611,260,3154,17,47,1,35,97,14924,1362,110,1170,11,16,1,15,39,39,1323,102,1260,564,1807,1362,445,853,509
"911","2010",42101010900,42,101,2313,414,1747,17,74,3,14,44,18411,879,151,677,6,27,1,5,12,22,857,144,735,448,1034,879,155,631,248
"912","2010",42101011000,42,101,3470,108,3248,9,7,1,30,67,20926,1453,52,1365,4,3,0,10,19,28,1425,45,1408,680,1846,1453,393,928,525
"913","2010",42101011100,42,101,3712,80,3496,22,37,1,24,52,18489,1399,31,1322,10,10,1,5,20,22,1377,29,1370,579,1753,1399,354,697,702
"914","2010",42101011200,42,101,5494,47,5250,29,17,0,17,134,24290,2076,17,1997,12,10,0,4,36,24,2052,15,2061,714,2455,2076,379,765,1311
"915","2010",42101011300,42,101,2917,29,2780,8,15,0,10,75,40435,1184,9,1142,2,3,0,3,25,16,1168,7,1177,437,1350,1184,166,366,818
"916","2010",42101011400,42,101,6126,159,5700,38,51,0,37,141,31716,2564,77,2396,14,14,0,12,51,46,2518,71,2493,1030,2926,2564,362,1090,1474
"917","2010",42101011500,42,101,4282,390,3706,14,40,1,39,92,52083,1580,212,1309,5,13,1,12,28,41,1539,202,1378,481,1696,1580,116,376,1204
"918","2010",42101011700,42,101,1931,1120,716,5,29,0,23,38,50417,378,104,252,2,3,0,3,14,7,371,100,278,145,401,378,23,92,286
"919","2010",42101011800,42,101,5621,156,5261,27,29,3,40,105,43396,2186,60,2056,9,8,1,11,41,25,2161,57,2129,709,2340,2186,154,446,1740
"920","2010",42101011900,42,101,5195,149,4816,25,35,3,40,127,36467,2168,64,2014,14,12,2,11,51,37,2131,59,2109,930,2431,2168,263,1026,1142
"921","2010",42101012000,42,101,1947,744,1076,8,51,1,21,46,43750,702,160,499,4,16,1,5,17,19,683,155,547,376,760,702,58,372,330
"922","2010",42101012100,42,101,2547,650,1702,9,108,0,19,59,34837,1190,289,803,6,60,0,6,26,15,1175,283,907,732,1588,1190,398,717,473
"923","2010",42101012201,42,101,2911,1218,1102,9,437,0,36,109,14939,2053,887,809,8,271,0,17,61,61,1992,850,1203,1647,2409,2053,356,2050,3
"924","2010",42101012203,42,101,1120,457,341,3,255,0,29,35,22036,672,312,171,0,153,0,16,20,21,651,304,368,554,894,672,222,670,2
"925","2010",42101012204,42,101,3564,924,2393,8,112,2,25,100,41528,1774,493,1158,3,59,0,11,50,40,1734,478,1296,1104,1925,1774,151,808,966
"926","2010",42101012500,42,101,5210,3616,584,11,801,2,70,126,52182,3302,2371,352,7,460,1,40,71,170,3132,2263,1039,2642,3555,3302,253,2755,547
"927","2010",42101013100,42,101,1529,289,1114,6,43,2,29,46,29458,682,175,451,4,22,2,14,14,38,644,164,518,347,785,682,103,487,195
"928","2010",42101013200,42,101,2914,297,2365,13,97,2,75,65,18607,963,76,804,8,33,1,27,14,64,899,58,905,458,1025,963,62,757,206
"929","2010",42101013300,42,101,2854,1422,1100,10,125,2,109,86,48647,1427,839,415,6,77,2,49,39,104,1323,801,626,1000,1637,1427,210,1122,305
"930","2010",42101013401,42,101,2288,2110,80,4,62,1,4,27,68641,1419,1319,55,3,33,0,1,8,34,1385,1291,128,954,1567,1419,148,543,876
"931","2010",42101013402,42,101,2922,2207,330,11,130,1,150,93,72083,1641,1295,171,3,66,1,57,48,138,1503,1235,406,1183,1730,1641,89,1119,522
"932","2010",42101013500,42,101,3222,1687,1267,6,78,0,110,74,58295,1401,829,484,1,32,0,37,18,87,1314,788,613,704,1582,1401,181,637,764
"933","2010",42101013601,42,101,2677,2388,86,0,117,0,18,68,98452,1480,1335,53,0,62,0,7,23,46,1434,1300,180,907,1580,1480,100,521,959
"934","2010",42101013602,42,101,3503,2997,273,5,115,0,25,88,76186,1798,1572,128,2,58,0,12,26,53,1745,1540,258,1072,1929,1798,131,692,1106
"935","2010",42101013700,42,101,4813,833,3716,7,80,3,45,129,25582,1993,425,1477,3,28,0,15,45,57,1936,409,1584,922,2461,1993,468,985,1008
"936","2010",42101013800,42,101,2061,127,1828,6,19,0,34,47,26500,827,67,728,2,5,0,12,13,19,808,64,763,363,1085,827,258,447,380
"937","2010",42101013900,42,101,3764,476,3106,10,32,2,57,81,15542,1287,138,1096,3,10,0,11,29,47,1240,123,1164,616,1465,1287,178,1104,183
"938","2010",42101014000,42,101,3010,439,2306,12,120,4,59,70,31684,1268,196,962,7,47,1,30,25,59,1209,176,1092,785,1561,1268,293,1021,247
"939","2010",42101014100,42,101,2094,272,1594,9,70,0,102,47,19808,937,145,663,4,36,0,67,22,137,800,102,835,511,1025,937,88,745,192
"940","2010",42101014200,42,101,3570,2825,296,1,149,1,168,130,68529,1813,1492,140,1,64,0,59,57,150,1663,1419,394,1203,2063,1813,250,1106,707
"941","2010",42101014300,42,101,1439,1252,66,1,53,1,26,40,57024,680,602,33,1,17,0,10,17,40,640,580,100,395,802,680,122,283,397
"942","2010",42101014400,42,101,3105,1726,589,22,63,1,523,181,34091,1307,785,205,12,21,0,224,60,486,821,590,717,695,1561,1307,254,704,603
"943","2010",42101014500,42,101,2464,587,1494,10,106,1,201,65,14286,659,45,504,5,11,0,74,20,131,528,13,646,265,713,659,54,472,187
"944","2010",42101014600,42,101,4289,1668,2237,16,210,1,58,99,22526,1163,212,877,6,42,0,8,18,29,1134,202,961,660,1192,1163,29,630,533
"945","2010",42101014700,42,101,3939,1813,1695,2,227,1,69,132,8980,958,366,477,1,51,0,20,43,50,908,351,607,668,1170,958,212,779,179
"946","2010",42101014800,42,101,785,21,707,1,31,0,7,18,11450,372,10,337,1,16,0,3,5,9,363,8,364,215,446,372,74,280,92
"947","2010",42101014900,42,101,3967,58,3775,15,19,0,25,75,21277,1633,25,1555,5,7,0,11,30,36,1597,19,1614,737,2099,1633,466,878,755
"948","2010",42101015101,42,101,2038,23,1959,7,6,3,13,27,17146,782,12,747,5,2,1,4,11,8,774,11,771,342,1097,782,315,465,317
"949","2010",42101015102,42,101,4269,28,4125,22,14,0,26,54,12316,1794,7,1747,10,5,0,7,18,28,1766,5,1789,773,2274,1794,480,1132,662
"950","2010",42101015200,42,101,6133,122,5776,18,20,1,55,141,15394,1936,40,1818,6,8,1,18,45,39,1897,37,1899,555,2372,1936,436,1371,565
"951","2010",42101015300,42,101,4962,2293,2254,6,266,0,42,101,10375,1434,518,808,1,68,0,14,25,46,1388,497,937,998,1783,1434,349,1131,303
"952","2010",42101015600,42,101,1741,536,425,28,29,1,658,64,16875,607,207,136,12,8,1,220,23,378,229,83,524,250,705,607,98,356,251
"953","2010",42101015700,42,101,2641,1328,325,35,33,1,766,153,26445,936,492,106,15,15,0,270,38,533,403,290,646,365,1099,936,163,434,502
"954","2010",42101015800,42,101,5684,5181,128,6,123,0,91,155,44222,2598,2409,57,2,47,0,33,50,93,2505,2359,239,1406,2884,2598,286,976,1622
"955","2010",42101016000,42,101,7002,6270,197,15,159,10,153,198,42994,2854,2617,72,6,63,3,47,46,111,2743,2570,284,1285,3205,2854,351,972,1882
"956","2010",42101016100,42,101,5590,2929,672,42,776,1,930,240,24091,1945,1168,187,15,229,0,283,63,493,1452,1021,924,811,2241,1945,296,1000,945
"957","2010",42101016200,42,101,2225,564,535,30,36,1,929,130,17314,769,223,169,9,7,1,314,46,580,189,40,729,268,897,769,128,511,258
"958","2010",42101016300,42,101,3248,1069,599,18,215,0,1191,156,12232,1031,372,162,5,69,0,370,53,774,257,63,968,299,1224,1031,193,559,472
"959","2010",42101016400,42,101,4564,978,1902,45,23,0,1361,255,13364,1485,353,576,14,7,0,447,88,918,567,22,1463,453,1739,1485,254,878,607
"960","2010",42101016500,42,101,2758,78,2522,9,12,0,96,41,13649,989,33,902,4,3,0,31,16,60,929,19,970,345,1218,989,229,620,369
"961","2010",42101016600,42,101,1788,262,1352,4,62,0,58,50,13750,586,69,474,2,13,0,11,17,21,565,66,520,305,729,586,143,411,175
"962","2010",42101016701,42,101,3055,71,2884,25,7,0,19,49,21987,1171,26,1104,8,3,0,5,25,17,1154,23,1148,471,1558,1171,387,550,621
"963","2010",42101016702,42,101,2903,180,2588,13,35,1,37,49,17076,1119,47,1014,7,11,0,15,25,30,1089,45,1074,513,1423,1119,304,638,481
"964","2010",42101016800,42,101,3935,55,3768,15,15,0,19,63,29375,1515,11,1469,6,3,0,6,20,23,1492,9,1506,607,1932,1515,417,660,855
"965","2010",42101016901,42,101,3466,32,3344,16,9,1,20,44,24313,1364,14,1316,7,3,0,9,15,20,1344,11,1353,527,1791,1364,427,582,782
"966","2010",42101016902,42,101,5524,35,5348,15,2,0,23,101,23427,2191,13,2126,6,2,0,8,36,33,2158,10,2181,863,2814,2191,623,1001,1190
"967","2010",42101017000,42,101,2953,567,2240,7,57,1,47,34,22413,1216,315,833,1,28,1,19,19,47,1169,300,916,606,1375,1216,159,812,404
"968","2010",42101017100,42,101,4047,36,3899,5,2,1,40,64,25551,1570,16,1520,4,1,1,9,19,22,1548,16,1554,527,1809,1570,239,541,1029
"969","2010",42101017201,42,101,3194,36,3065,13,10,0,30,40,19816,1289,11,1243,5,7,0,7,16,21,1268,9,1280,505,1536,1289,247,485,804
"970","2010",42101017202,42,101,4056,59,3896,11,7,0,32,51,19967,1593,19,1540,4,3,0,5,22,27,1566,9,1584,602,1986,1593,393,581,1012
"971","2010",42101017300,42,101,3165,103,2917,12,22,1,55,55,20036,1164,21,1102,3,5,0,12,21,24,1140,19,1145,439,1363,1164,199,530,634
"972","2010",42101017400,42,101,2419,49,2201,3,12,2,95,57,19750,918,13,848,3,4,2,27,21,46,872,7,911,369,1115,918,197,484,434
"973","2010",42101017500,42,101,7016,1726,2214,221,23,2,2544,286,14768,2274,570,748,76,8,2,776,94,1570,704,40,2234,655,2603,2274,329,1125,1149
"974","2010",42101017601,42,101,5562,2225,652,167,34,7,2108,369,12039,1834,770,199,56,10,2,688,109,1664,170,53,1781,581,2097,1834,263,1052,782
"975","2010",42101017602,42,101,3914,1421,708,88,46,1,1417,233,17535,1199,471,200,31,11,1,414,71,962,237,78,1121,348,1371,1199,172,637,562
"976","2010",42101017701,42,101,3705,870,1168,335,122,6,1047,157,19796,1088,287,341,106,41,2,276,35,595,493,138,950,254,1352,1088,264,680,408
"977","2010",42101017702,42,101,5076,1477,1077,292,136,2,1785,307,16036,1544,477,326,90,42,1,527,81,1028,516,186,1358,408,1824,1544,280,864,680
"978","2010",42101017800,42,101,6704,2114,1936,42,204,12,2023,373,20586,2059,749,554,13,57,2,596,88,918,1141,550,1509,641,2518,2059,459,1240,819
"979","2010",42101017900,42,101,6313,3160,1460,52,63,0,1269,309,23516,2095,1228,433,13,20,0,335,66,553,1542,1094,1001,669,2415,2095,320,963,1132
"980","2010",42101018001,42,101,2586,2399,63,6,26,1,42,49,33611,1093,1025,22,3,17,1,16,9,53,1040,995,98,480,1202,1093,109,443,650
"981","2010",42101018002,42,101,5451,5283,33,5,30,0,41,59,34966,2390,2328,15,3,13,0,12,19,50,2340,2293,97,1027,2630,2390,240,707,1683
"982","2010",42101018300,42,101,4313,4194,24,7,17,0,9,62,44742,1664,1639,7,1,5,0,3,9,16,1648,1626,38,558,1768,1664,104,259,1405
"983","2010",42101018400,42,101,2260,2152,9,6,16,1,26,50,42639,869,838,2,2,3,0,9,15,18,851,831,38,287,921,869,52,223,646
"984","2010",42101018800,42,101,8322,2896,2453,61,99,7,2373,433,23237,2483,1041,669,19,26,1,636,91,998,1485,822,1661,719,2849,2483,366,1302,1181
"985","2010",42101019000,42,101,7543,2451,1859,113,348,13,2382,377,27955,2403,903,581,32,99,2,686,100,1196,1207,571,1832,619,2568,2403,165,1005,1398
"986","2010",42101019100,42,101,7937,3003,1106,35,852,1,2517,423,29583,2634,1178,361,12,226,0,747,110,1360,1274,726,1908,686,2777,2634,143,648,1986
"987","2010",42101019200,42,101,7972,2347,2173,367,264,10,2438,373,21816,2333,781,592,113,69,2,677,99,1377,956,370,1963,551,2707,2333,374,1220,1113
"988","2010",42101019501,42,101,4927,1961,830,89,40,2,1734,271,13400,1584,668,232,29,13,1,559,82,1324,260,85,1499,456,1741,1584,157,921,663
"989","2010",42101019502,42,101,3675,1436,557,117,40,3,1347,175,17679,1132,463,158,37,11,1,411,51,933,199,79,1053,283,1291,1132,159,577,555
"990","2010",42101019700,42,101,7001,1428,2478,79,102,1,2514,399,21219,2127,469,755,21,27,1,733,121,1314,813,79,2048,501,2316,2127,189,913,1214
"991","2010",42101019800,42,101,6195,1190,2270,57,167,13,2173,325,21273,1925,387,752,16,50,4,637,79,1127,798,55,1870,483,2163,1925,238,879,1046
"992","2010",42101019900,42,101,4419,766,1809,48,13,0,1623,160,19697,1413,263,602,20,5,0,481,42,786,627,46,1367,418,1661,1413,248,709,704
"993","2010",42101020000,42,101,1265,107,1020,8,79,0,31,20,28646,589,61,452,3,51,0,10,12,25,564,54,535,337,787,589,198,420,169
"994","2010",42101020101,42,101,3547,92,3289,9,36,0,41,80,25034,1562,42,1453,6,12,0,19,30,51,1511,33,1529,798,2055,1562,493,1046,516
"995","2010",42101020102,42,101,3353,81,3130,12,14,0,36,80,31149,1317,28,1234,5,4,0,15,31,43,1274,20,1297,584,1678,1317,361,624,693
"996","2010",42101020200,42,101,5189,159,4848,19,13,2,31,117,21068,1961,24,1876,9,6,0,11,35,34,1927,20,1941,879,2550,1961,589,1016,945
"997","2010",42101020300,42,101,2769,140,2429,18,24,1,85,72,26071,1059,43,955,6,8,1,22,24,45,1014,36,1023,448,1340,1059,281,543,516
"998","2010",42101020400,42,101,3050,81,2829,8,16,4,46,66,30740,1130,24,1060,4,8,0,17,17,37,1093,16,1114,398,1392,1130,262,476,654
"999","2010",42101020500,42,101,2819,104,2549,11,100,0,12,43,20286,1273,56,1118,6,71,0,4,18,14,1259,53,1220,627,1416,1273,143,659,614
"1000","2010",42101020600,42,101,1819,1002,610,2,142,3,16,44,48875,875,449,322,1,85,2,4,12,30,845,432,443,524,990,875,115,609,266
"1001","2010",42101020700,42,101,5841,4674,776,6,197,0,39,149,66373,2505,2055,329,3,69,0,12,37,62,2443,2012,493,1369,2684,2505,179,953,1552
"1002","2010",42101020800,42,101,1971,1131,593,7,161,0,25,54,36218,1146,624,373,6,99,0,10,34,55,1091,588,558,897,1403,1146,257,790,356
"1003","2010",42101020900,42,101,2910,2596,128,4,88,0,12,82,61625,1368,1256,47,2,36,0,5,22,28,1340,1232,136,840,1463,1368,95,680,688
"1004","2010",42101021000,42,101,4917,4578,149,9,83,3,24,71,67132,2338,2210,66,2,33,1,7,19,43,2295,2178,160,1521,2528,2338,190,1112,1226
"1005","2010",42101021100,42,101,2327,2011,181,3,70,0,10,52,66964,1114,968,98,1,30,0,4,13,20,1094,956,158,552,1218,1114,104,374,740
"1006","2010",42101021200,42,101,2245,1946,153,1,80,0,22,43,62547,1060,927,78,0,37,0,6,12,29,1031,906,154,580,1134,1060,74,377,683
"1007","2010",42101021300,42,101,3551,3195,201,2,40,0,49,64,58386,1551,1438,60,1,22,0,14,16,41,1510,1419,132,869,1651,1551,100,676,875
"1008","2010",42101021400,42,101,3880,3450,258,6,64,3,22,77,59167,1809,1638,94,2,33,1,7,34,51,1758,1601,208,1269,2001,1809,192,1009,800
"1009","2010",42101021500,42,101,3857,3519,160,3,81,0,22,72,69855,1765,1623,74,2,38,0,6,22,40,1725,1591,174,1030,1924,1765,159,748,1017
"1010","2010",42101021600,42,101,1826,1539,166,5,68,0,14,34,49245,896,744,94,2,34,0,5,17,24,872,730,166,496,1016,896,120,507,389
"1011","2010",42101021700,42,101,5772,4911,474,17,203,1,47,119,65286,2449,2125,203,4,66,0,17,34,62,2387,2091,358,898,2571,2449,122,464,1985
"1012","2010",42101021800,42,101,4259,3311,564,6,226,2,46,104,52663,2173,1737,275,2,106,0,19,34,72,2101,1692,481,1359,2323,2173,150,1602,571
"1013","2010",42101021900,42,101,1432,1300,80,2,25,0,8,17,77644,689,615,50,1,15,0,2,6,14,675,605,84,327,721,689,32,79,610
"1014","2010",42101022000,42,101,1681,1437,152,0,57,2,4,29,73864,718,621,65,0,24,1,1,6,6,712,616,102,332,797,718,79,233,485
"1015","2010",42101023100,42,101,1262,1161,41,1,24,0,8,27,106927,526,490,20,0,9,0,1,6,16,510,476,50,185,562,526,36,193,333
"1016","2010",42101023500,42,101,1161,668,431,7,19,0,6,30,76548,540,308,211,5,4,0,4,8,6,534,306,234,241,577,540,37,172,368
"1017","2010",42101023600,42,101,2619,1492,984,5,38,0,19,81,77356,1095,659,389,3,15,0,5,24,28,1067,643,452,466,1165,1095,70,395,700
"1018","2010",42101023700,42,101,4566,1359,2929,14,39,1,49,175,44077,2162,709,1353,6,13,1,18,62,63,2099,686,1476,1225,2347,2162,185,1273,889
"1019","2010",42101023800,42,101,4391,1293,2825,23,46,0,37,167,33175,2077,610,1366,15,25,0,18,43,52,2025,599,1478,1256,2398,2077,321,1305,772
"1020","2010",42101023900,42,101,1777,341,1299,9,73,1,10,44,29346,1143,234,830,6,40,1,5,27,29,1114,224,919,848,1321,1143,178,1013,130
"1021","2010",42101024000,42,101,3822,1020,2482,13,136,1,37,133,33849,1851,521,1180,5,80,1,16,48,49,1802,504,1347,1090,2104,1851,253,1292,559
"1022","2010",42101024100,42,101,1433,211,1154,9,16,0,13,30,11353,733,100,606,3,7,0,5,12,14,719,96,637,569,824,733,91,649,84
"1023","2010",42101024200,42,101,4236,458,3538,15,18,3,52,152,28234,1710,233,1389,10,6,1,16,55,40,1670,228,1482,775,2019,1710,309,978,732
"1024","2010",42101024300,42,101,3913,397,3314,10,33,0,37,122,33427,1723,211,1435,5,18,0,9,45,33,1690,205,1518,735,1929,1723,206,950,773
"1025","2010",42101024400,42,101,3129,148,2840,14,24,2,23,78,33074,1151,62,1043,5,11,0,7,23,22,1129,62,1089,418,1350,1151,199,537,614
"1026","2010",42101024500,42,101,4035,128,3756,12,8,1,40,90,30446,1531,66,1411,5,2,1,12,34,35,1496,62,1469,612,1839,1531,308,902,629
"1027","2010",42101024600,42,101,2956,214,2607,13,11,2,55,54,19510,1151,91,1012,7,4,1,15,21,29,1122,87,1064,532,1304,1151,153,812,339
"1028","2010",42101024700,42,101,4423,292,3941,20,22,1,46,101,21765,1603,92,1449,13,8,0,9,32,26,1577,88,1515,591,1932,1603,329,747,856
"1029","2010",42101024800,42,101,1889,28,1800,12,7,0,10,32,36481,700,13,663,4,2,0,4,14,10,690,13,687,206,786,700,86,204,496
"1030","2010",42101024900,42,101,3311,49,3154,8,8,0,31,61,30762,1194,16,1143,3,1,0,10,21,20,1174,15,1179,368,1369,1194,175,425,769
"1031","2010",42101025200,42,101,7118,381,6396,31,33,2,76,199,34281,2783,133,2532,13,14,0,25,66,79,2704,122,2661,1205,3155,2783,372,1350,1433
"1032","2010",42101025300,42,101,4002,256,3557,24,25,1,31,108,33005,1648,123,1454,9,10,1,11,40,36,1612,112,1536,680,1944,1648,296,601,1047
"1033","2010",42101025400,42,101,3920,345,3414,9,12,3,28,109,52625,1816,155,1597,3,3,2,12,44,36,1780,146,1670,768,1999,1816,183,601,1215
"1034","2010",42101025500,42,101,2571,795,1585,12,41,0,24,114,79808,1079,341,682,6,11,0,5,34,24,1055,333,746,456,1148,1079,69,334,745
"1035","2010",42101025600,42,101,2742,1330,1194,7,53,0,37,121,69004,1149,557,526,5,18,0,10,33,30,1119,550,599,430,1191,1149,42,364,785
"1036","2010",42101025700,42,101,3463,2041,1119,9,161,0,30,103,64938,1885,1074,675,7,80,0,14,35,73,1812,1027,858,1136,2052,1885,167,1422,463
"1037","2010",42101025800,42,101,1681,58,1558,5,15,0,5,40,57083,761,32,708,3,4,0,2,12,9,752,31,730,305,788,761,27,166,595
"1038","2010",42101025900,42,101,4755,73,4525,11,8,5,41,92,37472,2060,39,1962,6,3,2,13,35,30,2030,37,2023,764,2151,2060,91,645,1415
"1039","2010",42101026000,42,101,2788,51,2650,10,8,0,13,56,44885,1197,24,1147,4,2,0,3,17,17,1180,23,1174,438,1252,1197,55,256,941
"1040","2010",42101026100,42,101,2995,52,2859,3,4,1,13,63,53013,1398,21,1340,1,1,1,4,30,16,1382,21,1377,590,1469,1398,71,426,972
"1041","2010",42101026200,42,101,4065,47,3867,19,8,0,20,104,50093,1758,27,1681,7,3,0,8,32,22,1736,26,1732,618,1833,1758,75,347,1411
"1042","2010",42101026301,42,101,3840,64,3670,12,8,1,8,77,41494,1555,37,1486,4,1,1,1,25,23,1532,35,1520,510,1623,1555,68,286,1269
"1043","2010",42101026302,42,101,5480,75,5206,10,24,0,35,130,41114,2082,29,1998,4,6,0,5,40,27,2055,27,2055,669,2179,2082,97,483,1599
"1044","2010",42101026400,42,101,5241,55,5034,20,11,2,9,110,43542,2143,24,2058,11,2,0,3,45,24,2119,22,2121,735,2271,2143,128,385,1758
"1045","2010",42101026500,42,101,4340,49,4172,21,3,0,16,79,46575,1687,22,1625,7,1,0,6,26,24,1663,22,1665,537,1865,1687,178,434,1253
"1046","2010",42101026600,42,101,6667,49,6466,18,9,0,31,94,44707,2492,20,2428,4,3,0,7,30,27,2465,16,2476,759,2648,2492,156,453,2039
"1047","2010",42101026700,42,101,6565,61,6292,20,24,0,44,124,35558,2549,22,2462,10,8,0,9,38,33,2516,16,2533,835,2788,2549,239,724,1825
"1048","2010",42101026800,42,101,4647,278,4066,15,102,2,57,127,36006,1873,93,1670,6,35,1,22,46,53,1820,84,1789,831,2141,1873,268,1194,679
"1049","2010",42101026900,42,101,2199,463,1481,10,60,2,105,78,46625,688,168,435,6,24,0,28,27,41,647,161,527,242,744,688,56,252,436
"1050","2010",42101027000,42,101,2326,294,1779,15,131,0,51,56,55436,922,122,723,5,37,0,15,20,29,893,113,809,360,981,922,59,402,520
"1051","2010",42101027100,42,101,2453,266,1497,9,515,0,107,59,47000,895,124,555,3,157,0,39,17,66,829,103,792,269,926,895,31,245,650
"1052","2010",42101027200,42,101,4278,374,3372,17,286,3,121,105,47694,1803,193,1424,10,104,1,38,33,94,1709,158,1645,670,1896,1803,93,696,1107
"1053","2010",42101027300,42,101,6069,701,3126,9,1404,2,651,176,43260,2052,311,1131,3,374,2,176,55,298,1754,224,1828,555,2158,2052,106,684,1368
"1054","2010",42101027401,42,101,3457,424,1689,7,964,6,241,126,26182,1140,167,579,3,286,1,70,34,152,988,114,1026,314,1237,1140,97,448,692
"1055","2010",42101027402,42,101,6800,857,4047,33,1052,9,583,219,34187,2246,367,1351,13,271,2,179,63,345,1901,252,1994,562,2393,2246,147,741,1505
"1056","2010",42101027500,42,101,4489,529,3022,24,545,0,259,110,40788,1559,246,1054,5,148,0,69,37,150,1409,198,1361,440,1666,1559,107,410,1149
"1057","2010",42101027600,42,101,3600,136,3243,20,58,1,32,110,30945,1520,68,1366,6,26,1,11,42,34,1486,62,1458,645,1805,1520,285,733,787
"1058","2010",42101027700,42,101,4788,47,4424,15,187,0,35,80,25101,2078,31,1858,5,142,0,13,29,31,2047,30,2048,956,2311,2078,233,1029,1049
"1059","2010",42101027800,42,101,4481,44,4258,19,44,1,29,86,31492,1931,17,1850,8,13,1,12,30,43,1888,16,1915,844,2203,1931,272,888,1043
"1060","2010",42101027901,42,101,3827,45,3637,14,10,2,30,89,31818,1430,19,1358,7,5,1,9,31,23,1407,19,1411,472,1653,1430,223,547,883
"1061","2010",42101027902,42,101,3873,1712,1949,5,55,1,44,107,31573,895,86,766,1,4,0,7,31,22,873,81,814,393,1093,895,198,390,505
"1062","2010",42101028000,42,101,4272,38,4063,17,27,1,46,80,22278,1604,17,1535,6,7,0,11,28,30,1574,16,1588,601,1860,1604,256,708,896
"1063","2010",42101028100,42,101,3589,130,3231,13,62,1,55,97,31250,1316,48,1192,5,24,0,17,30,43,1273,39,1277,451,1476,1316,160,439,877
"1064","2010",42101028200,42,101,4899,210,4115,19,305,1,104,145,38877,1939,108,1594,8,146,0,37,46,86,1853,86,1853,851,2193,1939,254,958,981
"1065","2010",42101028300,42,101,6173,166,5159,16,490,3,206,133,24396,2190,63,1883,6,145,1,52,40,83,2107,47,2143,756,2771,2190,581,1106,1084
"1066","2010",42101028400,42,101,4085,295,3104,36,61,0,446,143,23254,1283,97,992,13,15,0,131,35,242,1041,34,1249,307,1424,1283,141,526,757
"1067","2010",42101028500,42,101,2375,314,1124,7,319,1,510,100,26196,806,109,429,2,93,1,153,19,262,544,21,785,258,887,806,81,424,382
"1068","2010",42101028600,42,101,7124,976,3782,41,728,6,1359,232,25740,2182,326,1192,13,200,2,377,72,685,1497,123,2059,521,2375,2182,193,916,1266
"1069","2010",42101028700,42,101,2507,621,748,38,31,2,920,147,17192,791,206,239,11,11,1,277,46,517,274,40,751,194,878,791,87,382,409
"1070","2010",42101028800,42,101,4245,1098,1019,40,455,0,1433,200,25257,1309,374,334,14,127,0,412,48,718,591,157,1152,337,1442,1309,133,594,715
"1071","2010",42101028901,42,101,3857,1070,1074,26,278,3,1228,178,30970,1166,349,330,7,81,0,343,56,625,541,156,1010,274,1281,1166,115,463,703
"1072","2010",42101028902,42,101,6315,1413,1943,45,579,21,2021,293,28783,1843,465,588,13,155,5,543,74,900,943,215,1628,380,1975,1843,132,749,1094
"1073","2010",42101029000,42,101,6160,971,2802,26,1080,6,1023,252,30709,2003,400,939,6,303,1,278,76,509,1494,239,1764,526,2150,2003,147,738,1265
"1074","2010",42101029100,42,101,4685,898,1849,23,1212,7,504,192,27582,1526,364,630,10,331,1,134,56,305,1221,227,1299,382,1619,1526,93,790,736
"1075","2010",42101029200,42,101,4080,1150,1569,37,333,7,791,193,30191,1313,416,507,10,104,1,228,47,428,885,286,1027,301,1429,1313,116,448,865
"1076","2010",42101029300,42,101,2891,1028,1243,44,52,0,376,148,19709,997,446,374,8,19,0,111,39,251,746,354,643,361,1204,997,207,584,413
"1077","2010",42101029400,42,101,3141,917,1456,13,38,0,576,141,22260,1071,351,480,5,12,0,187,36,290,781,286,785,381,1283,1071,212,592,479
"1078","2010",42101029800,42,101,4715,2027,1754,18,127,6,553,230,24088,1772,900,589,6,41,2,167,67,334,1438,802,970,616,1934,1772,162,809,963
"1079","2010",42101029900,42,101,4700,1230,2483,32,71,1,691,192,21840,1544,513,755,9,22,0,197,48,365,1179,403,1141,435,1737,1544,193,892,652
"1080","2010",42101030000,42,101,7478,1518,4613,24,147,4,852,320,27959,2616,670,1555,11,50,1,253,76,407,2209,567,2049,985,3007,2616,391,1538,1078
"1081","2010",42101030100,42,101,5869,1743,3187,48,98,2,519,272,33021,2153,740,1127,18,32,0,167,69,355,1798,634,1519,800,2489,2153,336,1173,980
"1082","2010",42101030200,42,101,7345,2161,3712,41,173,16,812,430,35610,2491,883,1196,13,55,4,228,112,517,1974,710,1781,743,2652,2491,161,964,1527
"1083","2010",42101030501,42,101,5231,1218,2835,25,304,5,616,228,36563,1772,510,935,9,96,1,162,59,328,1444,396,1376,482,1918,1772,146,682,1090
"1084","2010",42101030502,42,101,5839,1454,3172,38,412,0,573,190,39508,1954,626,1000,8,115,0,155,50,297,1657,540,1414,516,2077,1954,123,481,1473
"1085","2010",42101030600,42,101,7115,3662,2063,15,443,3,689,240,38477,2686,1538,733,10,117,1,222,65,404,2282,1413,1273,1085,2872,2686,186,1172,1514
"1086","2010",42101030700,42,101,3235,1923,724,16,216,5,201,150,46509,1333,835,297,8,69,1,77,46,167,1166,777,556,572,1518,1333,185,818,515
"1087","2010",42101030800,42,101,4874,2854,920,5,647,7,297,144,54572,1717,1153,277,3,166,2,84,32,156,1561,1087,630,457,1798,1717,81,388,1329
"1088","2010",42101030900,42,101,3991,1347,1428,20,629,7,444,116,39483,1345,561,440,3,172,2,128,39,255,1090,443,902,355,1443,1345,98,559,786
"1089","2010",42101031000,42,101,6755,2960,1602,35,1416,19,541,182,54012,2174,1127,473,7,358,7,157,45,288,1886,1006,1168,521,2295,2174,121,664,1510
"1090","2010",42101031101,42,101,4898,1318,2061,51,580,10,677,201,33654,1574,553,596,11,156,5,204,49,289,1285,480,1094,399,1693,1574,119,698,876
"1091","2010",42101031102,42,101,4465,1168,2096,29,346,2,674,150,34031,1419,450,631,5,97,0,191,45,287,1132,383,1036,335,1505,1419,86,417,1002
"1092","2010",42101031200,42,101,4673,1312,2149,20,526,8,477,181,32500,1592,531,693,8,159,2,146,53,282,1310,429,1163,475,1698,1592,106,728,864
"1093","2010",42101031300,42,101,6945,2354,1859,59,1597,14,748,314,26882,2268,947,555,17,440,3,228,78,390,1878,796,1472,579,2384,2268,116,1028,1240
"1094","2010",42101031401,42,101,6664,2596,1473,27,1472,22,813,261,34823,2118,961,434,8,409,7,234,65,376,1742,818,1300,504,2222,2118,104,922,1196
"1095","2010",42101031402,42,101,5595,2362,891,12,1603,10,519,198,36074,1834,963,260,5,419,2,138,47,261,1573,866,968,452,1908,1834,74,552,1282
"1096","2010",42101031501,42,101,6217,5269,235,14,372,0,183,144,51020,2294,2037,68,4,106,0,51,28,114,2180,1987,307,708,2419,2294,125,604,1690
"1097","2010",42101031502,42,101,4018,3128,301,5,317,0,178,89,46977,1538,1262,115,3,90,0,51,17,91,1447,1220,318,506,1608,1538,70,516,1022
"1098","2010",42101031600,42,101,6045,4604,569,9,435,2,277,149,36775,2170,1772,165,3,122,0,79,29,150,2020,1712,458,627,2270,2170,100,459,1711
"1099","2010",42101031700,42,101,6093,3323,1364,21,497,5,636,247,43884,2240,1402,424,5,147,1,196,65,333,1907,1298,942,690,2365,2240,125,708,1532
"1100","2010",42101031800,42,101,4017,1421,1561,14,263,1,580,177,31951,1438,630,511,6,72,1,180,38,299,1139,538,900,471,1516,1438,78,411,1027
"1101","2010",42101031900,42,101,4971,2963,1141,19,121,2,508,217,39719,1716,1134,350,7,35,1,151,38,277,1439,1048,668,492,1862,1716,146,615,1101
"1102","2010",42101032000,42,101,6599,4609,1062,26,188,3,510,201,37399,2490,1886,343,6,56,1,154,44,294,2196,1782,708,846,2656,2490,166,653,1837
"1103","2010",42101032100,42,101,3903,2328,841,34,91,1,416,192,38387,1447,950,285,13,27,1,129,42,222,1225,889,558,526,1584,1447,137,634,813
"1104","2010",42101032300,42,101,3835,2358,951,29,100,1,268,128,34491,1451,963,333,8,32,1,85,29,165,1286,909,542,565,1574,1451,123,614,837
"1105","2010",42101032500,42,101,5766,4046,921,14,118,1,414,252,35259,2216,1698,294,6,42,1,123,52,227,1989,1617,599,876,2434,2216,218,913,1303
"1106","2010",42101032600,42,101,6942,5246,912,13,205,6,340,220,39583,2534,2047,275,4,65,1,104,38,223,2311,1944,590,841,2697,2534,163,772,1762
"1107","2010",42101032900,42,101,4089,2705,797,14,146,0,256,171,35401,1725,1219,334,5,39,0,88,40,175,1550,1149,576,769,1831,1725,106,775,950
"1108","2010",42101033000,42,101,7645,5384,1250,18,231,10,467,285,39848,2708,2094,361,8,73,1,122,49,267,2441,1980,728,833,2889,2708,181,828,1880
"1109","2010",42101033101,42,101,4913,4405,165,5,149,0,117,72,55924,1870,1730,49,2,39,0,38,12,82,1788,1690,180,602,1921,1870,51,402,1468
"1110","2010",42101033102,42,101,4145,3617,235,13,78,1,115,86,46571,1726,1543,100,5,22,1,39,16,82,1644,1506,220,703,1833,1726,107,645,1081
"1111","2010",42101033200,42,101,2741,2346,121,0,194,0,46,34,56484,1000,897,34,0,50,0,14,5,40,960,875,125,272,1034,1000,34,159,841
"1112","2010",42101033300,42,101,4244,3479,404,5,139,1,140,76,43799,1684,1377,183,2,48,1,51,22,93,1591,1336,348,774,1772,1684,88,638,1046
"1113","2010",42101033400,42,101,4734,3141,550,12,694,2,195,140,43093,1921,1381,233,4,198,0,66,39,175,1746,1278,643,754,2025,1921,104,831,1090
"1114","2010",42101033500,42,101,3680,2361,350,27,588,1,234,119,57176,1388,1010,121,8,150,1,72,26,123,1265,952,436,481,1444,1388,56,449,939
"1115","2010",42101033600,42,101,6866,5171,585,22,555,2,378,153,52091,2848,2280,253,5,153,1,121,35,216,2632,2171,677,1133,2999,2848,151,1463,1385
"1116","2010",42101033701,42,101,5128,4152,287,9,364,0,171,145,26643,2291,1975,117,3,103,0,54,39,161,2130,1881,410,1003,2430,2291,139,1358,933
"1117","2010",42101033702,42,101,5175,3864,430,6,641,0,138,96,70230,1992,1609,131,1,178,0,54,19,127,1865,1533,459,646,2063,1992,71,479,1513
"1118","2010",42101033800,42,101,6040,4788,538,8,287,0,241,178,43204,2533,2085,217,2,91,0,83,55,151,2382,2013,520,1024,2651,2533,118,1042,1491
"1119","2010",42101033900,42,101,2924,2379,222,7,118,1,121,76,47578,1243,1045,104,4,41,1,34,14,75,1168,1004,239,509,1305,1243,62,446,797
"1120","2010",42101034000,42,101,2872,2411,108,6,210,0,85,52,56768,1072,955,34,2,54,0,19,8,49,1023,929,143,311,1106,1072,34,122,950
"1121","2010",42101034100,42,101,5577,4928,271,9,192,2,75,100,51190,2498,2207,135,5,86,0,36,29,94,2404,2152,346,1086,2622,2498,124,1089,1409
"1122","2010",42101034200,42,101,3399,2898,287,3,144,0,30,37,44507,1580,1408,108,1,45,0,8,10,39,1541,1384,196,703,1665,1580,85,836,744
"1123","2010",42101034400,42,101,7662,6273,220,19,948,1,107,94,83146,2733,2360,70,7,239,0,27,30,85,2648,2306,427,642,2807,2733,74,276,2457
"1124","2010",42101034501,42,101,3370,2429,306,5,502,2,74,52,25650,1827,1482,140,1,162,2,24,16,76,1751,1433,394,1016,1932,1827,105,1553,274
"1125","2010",42101034502,42,101,5285,3573,868,9,489,0,143,203,40631,2427,1757,412,2,159,0,49,48,143,2284,1682,745,1075,2554,2427,127,1394,1033
"1126","2010",42101034600,42,101,2250,1293,576,5,240,1,87,48,37326,1215,781,302,0,74,1,36,21,106,1109,725,490,698,1303,1215,88,906,309
"1127","2010",42101034701,42,101,6399,4448,703,25,833,2,188,200,56915,2465,1844,276,9,217,2,65,52,181,2284,1740,725,792,2555,2465,90,594,1871
"1128","2010",42101034702,42,101,3807,3208,278,11,176,0,73,61,61803,1438,1234,111,3,50,0,25,15,75,1363,1197,241,408,1475,1438,37,221,1217
"1129","2010",42101034801,42,101,4299,3880,223,9,62,3,48,74,43125,1942,1796,89,4,19,2,18,14,57,1885,1763,179,781,1996,1942,54,882,1060
"1130","2010",42101034802,42,101,5373,3679,1229,13,134,4,160,154,40670,2178,1497,533,7,45,1,58,37,157,2021,1421,757,813,2281,2178,103,997,1181
"1131","2010",42101034803,42,101,4390,3838,282,7,117,0,85,61,60119,1731,1549,102,4,37,0,27,12,69,1662,1509,222,523,1794,1731,63,365,1366
"1132","2010",42101034900,42,101,5543,3781,1042,30,300,2,214,174,40861,2159,1571,396,11,78,1,71,31,189,1970,1470,689,793,2732,2159,573,865,1294
"1133","2010",42101035100,42,101,4086,3769,166,7,67,1,44,32,43442,2344,2202,85,3,25,1,13,15,46,2298,2173,171,1386,2462,2344,118,844,1500
"1134","2010",42101035200,42,101,4482,4034,90,5,258,1,42,52,76402,1758,1638,22,2,73,0,9,14,43,1715,1605,153,590,1828,1758,70,443,1315
"1135","2010",42101035301,42,101,5300,4715,216,9,191,1,62,106,70010,1995,1804,90,1,55,1,19,25,61,1934,1765,230,602,2061,1995,66,398,1597
"1136","2010",42101035302,42,101,4462,3853,252,4,161,0,89,103,57214,1919,1683,127,2,50,0,37,20,77,1842,1649,270,791,2013,1919,94,712,1207
"1137","2010",42101035500,42,101,7282,5709,331,17,883,5,181,156,52045,2976,2492,137,10,235,0,59,43,131,2845,2431,545,982,3079,2976,103,1023,1953
"1138","2010",42101035601,42,101,5439,4794,51,10,454,1,63,66,46772,2432,2253,24,2,122,1,16,14,60,2372,2211,221,1021,2525,2432,93,788,1644
"1139","2010",42101035602,42,101,3617,2552,198,10,733,4,58,62,67096,1279,972,72,1,194,1,18,21,49,1230,943,336,292,1310,1279,31,278,1001
"1140","2010",42101035701,42,101,4745,2733,439,25,1222,0,110,216,38712,1932,1293,180,9,346,0,37,67,90,1842,1255,677,682,2007,1932,75,1320,612
"1141","2010",42101035702,42,101,4405,3692,132,13,373,4,70,121,42052,1752,1543,43,2,102,2,22,38,53,1699,1514,238,549,1821,1752,69,1135,617
"1142","2010",42101035800,42,101,5948,4834,313,16,546,2,90,147,57500,2290,1952,115,4,157,0,30,32,84,2206,1903,387,622,2347,2290,57,400,1890
"1143","2010",42101035900,42,101,5309,4271,204,12,601,0,88,133,48702,2210,1891,84,2,170,0,29,34,79,2131,1848,362,779,2242,2210,32,690,1520
"1144","2010",42101036000,42,101,3201,2071,295,7,666,1,64,97,49417,1157,827,109,2,177,0,15,27,41,1116,806,351,445,1188,1157,31,452,705
"1145","2010",42101036100,42,101,4083,3118,679,0,70,1,111,104,58652,1530,1159,289,0,24,0,35,23,103,1427,1106,424,445,1628,1530,98,528,1002
"1146","2010",42101036201,42,101,4744,4210,193,21,120,0,81,119,53807,1973,1764,93,7,44,0,39,26,106,1867,1711,262,703,2149,1973,176,598,1375
"1147","2010",42101036202,42,101,6138,5379,380,3,180,5,75,116,68084,2349,2070,177,0,54,1,22,25,72,2277,2026,323,675,2409,2349,60,358,1991
"1148","2010",42101036203,42,101,5129,4702,140,7,136,0,78,66,53571,1880,1740,52,3,41,0,27,17,99,1781,1677,203,466,1923,1880,43,189,1691
"1149","2010",42101036301,42,101,3695,3029,146,3,302,0,106,109,53846,1341,1158,55,1,80,0,25,22,55,1286,1131,210,347,1382,1341,41,202,1139
"1150","2010",42101036302,42,101,3543,2596,554,9,93,1,167,123,65111,1265,961,205,3,27,0,47,22,97,1168,921,344,323,1346,1265,81,345,920
"1151","2010",42101036303,42,101,6726,6336,120,4,126,1,66,73,60205,2470,2358,45,3,38,0,16,10,50,2420,2327,143,603,2519,2470,49,181,2289
"1152","2010",42101036400,42,101,703,534,152,0,10,0,3,4,114688,66,56,4,0,3,0,1,2,3,63,55,11,31,417,66,351,19,47
"1153","2010",42101036501,42,101,5562,4700,453,5,228,0,84,92,57888,2345,1998,215,2,67,0,32,31,101,2244,1945,400,979,2458,2345,113,1120,1225
"1154","2010",42101036502,42,101,4077,3753,84,5,114,0,69,52,78068,1490,1387,29,0,37,0,21,16,41,1449,1365,125,365,1518,1490,28,163,1327
"1155","2010",42101036600,42,101,1643,1306,104,7,171,0,24,31,126875,991,798,64,6,95,0,9,19,27,964,783,208,653,1350,991,359,431,560
"1156","2010",42101036700,42,101,2542,1875,409,6,104,2,88,58,84511,1378,1078,179,3,49,1,39,29,79,1299,1041,337,927,1529,1378,151,771,607
"1157","2010",42101036900,42,101,6966,3577,776,4,2255,7,59,288,47614,680,414,30,0,210,0,4,22,30,650,395,285,545,708,680,28,678,2
"1158","2010",42101037200,42,101,4244,3140,239,2,653,0,134,76,47222,1773,1450,90,1,187,0,30,15,55,1718,1430,343,666,1882,1773,109,331,1442
"1159","2010",42101037300,42,101,5137,4232,534,7,263,1,54,46,47500,2362,1907,304,4,101,1,22,23,42,2320,1889,473,1036,2625,2362,263,951,1411
"1160","2010",42101037500,42,101,3771,1943,1460,17,184,1,48,118,64659,1479,748,603,6,72,1,13,36,41,1438,730,749,723,1557,1479,78,719,760
"1161","2010",42101037600,42,101,2986,1133,1046,15,610,1,112,69,53417,1106,580,253,1,218,0,30,24,71,1035,542,564,753,1220,1106,114,794,312
"1162","2010",42101037700,42,101,5635,2017,2786,22,218,0,439,153,16862,1351,289,828,10,53,0,136,35,269,1082,218,1133,549,1506,1351,155,977,374
"1163","2010",42101037800,42,101,2504,2274,103,3,43,1,39,41,45441,1053,983,30,1,16,0,12,11,47,1006,952,101,513,1192,1053,139,368,685
"1164","2010",42101037900,42,101,5315,5053,49,8,69,4,64,68,31169,2229,2159,12,2,29,0,13,14,32,2197,2140,89,829,2386,2229,157,527,1702
"1165","2010",42101038000,42,101,2375,1761,256,8,18,7,224,101,42744,866,686,80,4,7,2,67,20,120,746,655,211,303,960,866,94,317,549
"1166","2010",42101038100,42,101,833,488,224,2,2,0,73,44,25074,289,186,73,1,1,0,17,11,36,253,173,116,102,332,289,43,138,151
"1167","2010",42101038200,42,101,2631,1695,390,18,29,0,356,143,26715,910,643,120,5,12,0,105,25,192,718,588,322,305,1032,910,122,368,542
"1168","2010",42101038300,42,101,4157,986,1506,34,32,4,1390,205,20921,1024,271,245,9,7,1,443,48,742,282,64,960,295,1126,1024,102,513,511
"1169","2010",42101038400,42,101,2437,2116,177,0,93,0,11,40,76000,976,858,71,0,33,0,6,8,24,952,844,132,291,1007,976,31,179,797
"1170","2010",42101038500,42,101,1888,1679,92,4,69,0,15,29,89864,890,805,44,0,27,0,3,11,13,877,794,96,435,939,890,49,385,505
"1171","2010",42101038600,42,101,1320,1100,166,1,21,0,8,24,105987,572,482,70,0,7,0,3,10,5,567,478,94,191,605,572,33,146,426
"1172","2010",42101038700,42,101,2348,1942,295,3,48,1,8,51,101964,702,642,39,0,13,0,2,6,12,690,631,71,241,735,702,33,136,566
"1173","2010",42101038800,42,101,3718,2226,1226,10,88,4,19,145,73462,1765,1051,632,3,23,2,5,49,40,1725,1030,735,855,1905,1765,140,613,1152
"1174","2010",42101038900,42,101,3080,132,2824,5,6,0,28,85,43306,1249,35,1160,4,2,0,9,39,25,1224,32,1217,510,1343,1249,94,530,719
"1175","2010",42101039000,42,101,8154,1855,4728,25,269,15,992,270,31585,2629,756,1445,8,85,3,268,64,530,2099,569,2060,659,2827,2629,198,1147,1482
"1176","2010",42101980000,42,101,601,348,144,2,79,0,5,23,19250,82,60,13,0,5,0,1,3,2,80,59,23,57,85,82,3,37,45
"1177","2010",42101980100,42,101,74,67,4,0,1,0,0,2,48667,40,36,3,0,0,0,0,1,2,38,34,6,21,46,40,6,17,23
"1178","2010",42101980200,42,101,504,476,10,0,9,0,5,4,148333,65,60,1,0,3,0,1,0,1,64,60,5,18,65,65,0,4,61
"1179","2010",42101980300,42,101,2,2,0,0,0,0,0,0,NA,1,1,0,0,0,0,0,0,0,1,1,0,0,1,1,0,0,1
"1180","2010",42101980400,42,101,0,0,0,0,0,0,0,0,NA,0,0,0,0,0,0,0,0,0,0,0,0,0,0,0,0,0,0
"1181","2010",42101980500,42,101,0,0,0,0,0,0,0,0,NA,0,0,0,0,0,0,0,0,0,0,0,0,0,0,0,0,0,0
"1182","2010",42101980600,42,101,0,0,0,0,0,0,0,0,NA,0,0,0,0,0,0,0,0,0,0,0,0,0,0,0,0,0,0
"1183","2010",42101980700,42,101,5,0,4,0,1,0,0,0,NA,1,0,1,0,0,0,0,0,0,1,0,1,1,1,1,0,1,0
"1184","2010",42101980800,42,101,6,4,1,0,0,0,0,1,NA,4,2,1,0,0,0,0,1,0,4,2,2,3,4,4,0,3,1
"1185","2010",42101980900,42,101,30,9,20,0,0,0,0,1,NA,19,6,12,0,0,0,0,1,0,19,6,13,13,20,19,1,17,2
"1186","2010",42101989100,42,101,7765,1022,5564,0,51,0,1112,16,NA,0,0,0,0,0,0,0,0,0,0,0,0,0,0,0,0,0,0
