Geo_Name,Geo_QName,Geo_SUMLEV,Geo_FIPS,Geo_state,Geo_county,SE_T001_001,SE_T005_001,SE_T005_002,SE_T005_003,SE_T005_004,SE_T023_001,SE_T038_001,SE_T045_001,SE_T046_001,SE_T046_002,SE_T046_003,SE_T046_004,SE_T046_005,SE_T051_001,SE_T051_002,SE_T051_003
"B0001","1","140","42017B0010000","42","017",5269,5269,5170,91,8,32120,1379,1580,1580,1388,192,26,166,1388,1088,300
"B0002","2","140","42017B0020000","42","017",6096,6096,5803,293,0,32500,1659,1824,1824,1662,162,21,141,1662,1384,278
"B0003","3","140","42017B0030000","42","017",7248,7248,7244,2,2,32930,1960,2161,2161,1959,202,41,161,1959,1647,312
"B0004","4","140","42017B0040000","42","017",4936,4936,4729,206,1,32180,1345,1402,1402,1355,47,24,23,1355,637,718
"B0005","5","140","42017B0050000","42","017",3083,3083,3082,0,1,34250,873,881,881,867,14,2,12,867,644,223
"B0006","6","140","42017B0060000","42","017",5793,5793,5607,183,3,30290,1576,1605,1605,1580,25,7,18,1580,958,622
"B0007","7","140","42017B0070000","42","017",3834,3834,3727,106,1,32500,959,983,983,966,17,12,5,966,707,259
"B0008","8","140","42017B0080000","42","017",2646,2646,2617,29,0,24850,670,775,775,669,106,15,91,669,473,196
"B0009","9","140","42017B0090000","42","017",2341,2341,2341,0,0,33610,656,827,827,654,173,16,157,654,545,109
"B0010","10","140","42017B0100000","42","017",860,860,860,0,0,0,254,282,282,254,28,7,21,254,154,100
"B0011","11","140","42017B0110000","42","017",1100,1100,1100,0,0,0,295,308,308,295,13,4,9,295,212,83
"B0012","12","140","42017B0120000","42","017",781,781,745,36,0,0,151,162,162,152,10,1,9,152,116,36
"B0013","13","140","42017B0130000","42","017",1579,1579,1392,185,2,27290,439,444,444,436,8,3,5,436,271,165
"B0014","14","140","42017B0140000","42","017",3562,3562,3556,6,0,33880,1024,1194,1194,1022,172,13,159,1022,900,122
"B0015","15","140","42017B0150000","42","017",2027,2027,2010,11,6,40250,603,623,623,601,22,6,16,601,505,96
"B0016","16","140","42017B0160000","42","017",7127,7127,7081,33,13,30990,1767,1824,1824,1761,63,8,55,1761,464,1297
"B0017","17","140","42017B0170000","42","017",358,358,358,0,0,0,107,108,108,106,2,1,1,106,75,31
"B0018","18","140","42017B0180000","42","017",2336,2336,2316,18,2,31330,655,731,731,653,78,8,70,653,515,138
"B0019","19","140","42017B0190000","42","017",828,828,818,10,0,0,225,240,240,224,16,5,11,224,163,61
"B0020","20","140","42017B0200000","42","017",1367,1367,1363,4,0,0,388,427,427,390,37,4,33,390,307,83
"B0021","21","140","42017B0210000","42","017",3688,3688,3678,6,4,26390,983,1046,1046,980,66,10,56,980,755,225
"B0022","22","140","42017B0220000","42","017",384,384,384,0,0,0,114,119,119,114,5,5,0,114,73,41
"B0023","23","140","42017B0230000","42","017",1626,1626,1565,61,0,0,465,535,535,464,71,12,59,464,331,133
"B0024","24","140","42017B0240000","42","017",4358,4358,4354,4,0,32240,1316,1418,1418,1317,101,8,93,1317,935,382
"B0025","25","140","42017B0250000","42","017",2373,2373,2371,2,0,32320,719,751,751,730,21,8,13,730,508,222
"B0026","26","140","42017B0260000","42","017",528,528,528,0,0,0,146,150,150,147,3,0,3,147,103,44
"B0027","27","140","42017B0270000","42","017",2020,2020,1999,21,0,22670,537,687,687,536,151,11,140,536,415,121
"B0028","28","140","42017B0280000","42","017",2865,2865,2865,0,0,24260,767,927,927,770,157,16,141,770,589,181
"B0029","29","140","42017B0290000","42","017",838,838,838,0,0,0,239,243,243,238,5,0,5,238,146,92
"B0030","30","140","42017B0300000","42","017",3050,3050,3041,9,0,30000,853,909,909,860,49,3,46,860,636,224
"B0031","31","140","42017B0310000","42","017",5673,5673,5662,11,0,30380,1783,1813,1813,1788,25,14,11,1788,1137,651
"B0032","32","140","42017B0320000","42","017",762,762,760,2,0,0,215,216,216,213,3,2,1,213,139,74
"B0033","33","140","42017B0330000","42","017",1084,1084,1074,9,1,0,293,362,362,300,62,0,62,300,222,78
"B0034","34","140","42017B0340000","42","017",2668,2668,2662,3,3,26580,752,836,836,751,85,6,79,751,522,229
"B0035","35","140","42017B0350000","42","017",668,668,668,0,0,0,198,236,236,197,39,6,33,197,136,61
"B0036","36","140","42017B0360000","42","017",871,871,871,0,0,0,280,289,289,279,10,5,5,279,165,114
"B0037","37","140","42017B0370000","42","017",1305,1305,1305,0,0,0,377,464,464,379,85,12,73,379,320,59
"B0038","38","140","42017B0380000","42","017",944,944,944,0,0,0,264,311,311,261,50,5,45,261,197,64
"B0039","39","140","42017B0390000","42","017",1552,1552,1550,1,1,25750,477,718,718,483,235,18,217,483,370,113
"B0040","40","140","42017B0400000","42","017",2268,2268,2262,6,0,32500,636,708,708,637,71,5,66,637,470,167
"B0041","41","140","42017B0410000","42","017",400,400,396,1,3,0,120,121,121,120,1,0,1,120,81,39
"B0042","42","140","42017B0420000","42","017",2353,2353,2347,6,0,32340,690,820,820,695,125,17,108,695,514,181
"B0043","43","140","42017B0430000","42","017",2208,2208,2163,42,3,33330,688,820,820,683,137,37,100,683,465,218
"B0044","44","140","42017B0440000","42","017",1066,1066,1044,22,0,0,362,388,388,362,26,9,17,362,209,153
"B0045","45","140","42017B0450000","42","017",3007,3007,2939,67,1,29900,889,963,963,889,74,11,63,889,640,249
"B0046","46","140","42017B0460000","42","017",2364,2364,2325,37,2,22810,594,640,640,593,47,9,38,593,417,176
"B0047","47","140","42017B0470000","42","017",5262,5262,5183,78,1,33270,1631,1682,1682,1636,46,20,26,1636,959,677
"B0048","48","140","42017B0480000","42","017",581,581,581,0,0,0,174,174,174,172,2,1,1,172,143,29
"B0049","49","140","42017B0490000","42","017",906,906,895,11,0,0,259,305,305,259,46,3,43,259,197,62
"B0050","50","140","42017B0500000","42","017",2248,2248,2240,8,0,30710,625,682,682,627,55,4,51,627,429,198
"B0051","51","140","42017B0510000","42","017",909,909,901,8,0,0,281,316,316,282,34,3,31,282,190,92
"B0052","52","140","42017B0520000","42","017",1013,1013,918,94,1,0,299,308,308,299,9,1,8,299,202,97
"B0053","53","140","42017B0530000","42","017",2095,2095,2005,90,0,31360,655,669,669,654,15,7,8,654,378,276
"B0054","54","140","42017B0540000","42","017",1410,1410,1390,20,0,0,409,456,456,409,47,2,45,409,271,138
"B0055","55","140","42017B0550000","42","017",3211,3211,3151,58,2,49320,895,971,971,900,71,17,54,900,731,169
"B0056","56","140","42017B0560000","42","017",1916,1916,1743,173,0,37050,551,575,575,553,22,10,12,553,382,171
"B0057","57","140","42017B0570000","42","017",6787,6787,6739,47,1,39420,1987,2071,2071,2001,70,24,46,2001,1513,488
"B0058","58","140","42017B0580000","42","017",3540,3540,3170,368,2,30630,970,1081,1081,972,109,2,107,972,522,450
"B0059","59","140","42017B0590000","42","017",648,648,634,13,1,0,172,170,170,170,0,0,0,170,109,61
"D0001","1","140","42045D0010000","42","045",901,901,901,0,0,0,334,343,343,335,8,8,0,335,86,249
"D0002","2","140","42045D0020000","42","045",3682,3682,3681,1,0,36330,1100,1111,1111,1101,10,4,6,1101,871,230
"D0003","3","140","42045D0030000","42","045",13043,13043,12929,111,3,37620,3850,3923,3923,3864,59,8,51,3864,3155,709
"D0004","4","140","42045D0040000","42","045",9566,9566,9545,11,10,41920,3133,3159,3159,3119,40,13,27,3119,2179,940
"D0005","5","140","42045D0050000","42","045",5038,5038,5032,2,4,38830,1415,1429,1429,1413,16,6,10,1413,1186,227
"D0006","6","140","42045D0060000","42","045",5890,5890,5885,5,0,43850,1663,1689,1689,1668,21,15,6,1668,1355,313
"D0007","7","140","42045D0070000","42","045",5939,5939,5918,20,1,48270,1681,1704,1704,1679,25,18,7,1679,1299,380
"D0008","8","140","42045D0080000","42","045",4745,4745,4736,8,1,44710,1452,1484,1484,1451,33,23,10,1451,1146,305
"D0009","9","140","42045D0090000","42","045",1693,1693,1679,14,0,76430,481,490,490,482,8,8,0,482,458,24
"D0010","10","140","42045D0100000","42","045",2855,2855,2848,6,1,47500,841,853,853,843,10,6,4,843,654,189
"D0011","11","140","42045D0110000","42","045",10062,10062,10048,14,0,46550,2929,3155,3155,2935,220,205,15,2935,2628,307
"D0012","12","140","42045D0120000","42","045",3748,3748,3745,2,1,52930,1095,1158,1158,1109,49,35,14,1109,860,249
"D0013","13","140","42045D0130000","42","045",6291,6291,6290,0,1,51800,2041,2233,2233,2051,182,136,46,2051,773,1278
"D0014","14","140","42045D0140000","42","045",6425,6425,6418,4,3,42770,1755,1801,1801,1767,34,29,5,1767,1513,254
"D0015","15","140","42045D0150000","42","045",4918,4918,4909,9,0,41470,1367,1428,1428,1364,64,47,17,1364,1295,69
"D0016","16","140","42045D0160000","42","045",1056,1056,1054,1,1,0,265,272,272,262,10,9,1,262,250,12
"D0017","17","140","42045D0170000","42","045",3527,3527,3516,4,7,33500,975,990,990,979,11,8,3,979,682,297
"D0018","18","140","42045D0180000","42","045",4470,4470,4458,8,4,46090,1373,1387,1387,1377,10,6,4,1377,976,401
"D0019","19","140","42045D0190000","42","045",5005,5005,4995,9,1,49110,1556,1572,1572,1557,15,9,6,1557,1159,398
"D0020","20","140","42045D0200000","42","045",2694,2694,2443,251,0,40250,838,851,851,840,11,2,9,840,467,373
"D0021","21","140","42045D0210000","42","045",7296,7296,7291,4,1,44610,2045,2066,2066,2036,30,13,17,2036,1722,314
"D0022","22","140","42045D0220000","42","045",2240,2240,1598,642,0,33570,592,596,596,592,4,1,3,592,513,79
"D0023","23","140","42045D0230000","42","045",1532,1532,1531,1,0,0,430,436,436,429,7,1,6,429,404,25
"D0024","24","140","42045D0240000","42","045",4344,4344,4337,5,2,33950,1227,1242,1242,1222,20,12,8,1222,833,389
"D0025","25","140","42045D0250000","42","045",4869,4869,3028,1836,5,27210,1326,1328,1328,1318,10,3,7,1318,887,431
"D0026","26","140","42045D0260000","42","045",3941,3941,3934,7,0,36740,1019,1037,1037,1023,14,0,14,1023,949,74
"D0027","27","140","42045D0270000","42","045",2143,2143,2126,17,0,33270,577,598,598,572,26,1,25,572,420,152
"D0028","28","140","42045D0280000","42","045",5464,5464,5440,24,0,41710,1505,1533,1533,1510,23,7,16,1510,1152,358
"D0029","29","140","42045D0290000","42","045",2539,2539,271,2268,0,7290,579,590,590,580,10,0,10,580,328,252
"D0030","30","140","42045D0300000","42","045",915,915,480,433,2,0,220,230,230,220,10,1,9,220,149,71
"D0031","31","140","42045D0310000","42","045",8443,8443,8435,6,2,35520,2367,2414,2414,2361,53,17,36,2361,1747,614
"D0032","32","140","42045D0320000","42","045",3430,3430,3430,0,0,43440,1004,1015,1015,998,17,4,13,998,833,165
"D0033","33","140","42045D0330000","42","045",7549,7549,7546,2,1,39130,1937,1970,1970,1939,31,11,20,1939,1601,338
"D0034","34","140","42045D0340000","42","045",1909,1909,1892,16,1,0,529,543,543,536,7,2,5,536,379,157
"D0035","35","140","42045D0350000","42","045",6450,6450,6446,3,1,39130,1786,1817,1817,1790,27,15,12,1790,1230,560
"D0036","36","140","42045D0360000","42","045",5246,5246,5211,33,2,37620,1548,1579,1579,1555,24,11,13,1555,934,621
"D0037","37","140","42045D0370000","42","045",5314,5314,5308,2,4,33370,1335,1365,1365,1345,20,8,12,1345,803,542
"D0038","38","140","42045D0380000","42","045",5834,5834,5728,104,2,40170,1762,1790,1790,1772,18,10,8,1772,1312,460
"D0039","39","140","42045D0390000","42","045",4921,4921,4909,10,2,43150,1502,1545,1545,1505,40,25,15,1505,1008,497
"D0040","40","140","42045D0400000","42","045",7212,7212,7141,67,4,40060,1985,1996,1996,1958,38,19,19,1958,1694,264
"D0041","41","140","42045D0410000","42","045",10000,10000,9554,441,5,37660,2691,2723,2723,2689,34,20,14,2689,1518,1171
"D0042","42","140","42045D0420000","42","045",919,919,919,0,0,0,259,266,266,262,4,0,4,262,209,53
"D0043","43","140","42045D0430000","42","045",3014,3014,3009,2,3,34680,819,834,834,817,17,12,5,817,491,326
"D0044","44","140","42045D0440000","42","045",1285,1285,1283,1,1,0,401,407,407,398,9,8,1,398,258,140
"D0045","45","140","42045D0450000","42","045",3838,3838,3836,2,0,38360,1138,1148,1148,1138,10,4,6,1138,933,205
"D0046","46","140","42045D0460000","42","045",2010,2010,2009,0,1,4320,568,592,592,583,9,1,8,583,517,66
"D0047","47","140","42045D0470000","42","045",4588,4588,4206,378,4,30420,1266,1304,1304,1267,37,18,19,1267,675,592
"D0048","48","140","42045D0480000","42","045",4681,4681,4677,4,0,32120,1267,1287,1287,1266,21,12,9,1266,824,442
"D0049","49","140","42045D0490000","42","045",6642,6642,6404,233,5,28570,1952,2046,2046,1969,77,40,37,1969,743,1226
"D0050","50","140","42045D0500000","42","045",3743,3743,3726,15,2,32160,1140,1171,1171,1141,30,11,19,1141,541,600
"D0051","51","140","42045D0510000","42","045",3352,3352,3183,169,0,32760,903,916,916,896,20,4,16,896,631,265
"D0052","52","140","42045D0520000","42","045",4888,4888,697,4188,3,24240,1187,1208,1208,1194,14,2,12,1194,387,807
"D0053","53","140","42045D0530000","42","045",4428,4428,4412,16,0,40090,1106,1128,1128,1104,24,18,6,1104,932,172
"D0054","54","140","42045D0540000","42","045",4220,4220,4217,1,2,37430,1143,1159,1159,1142,17,6,11,1142,492,650
"D0055","55","140","42045D0550000","42","045",2891,2891,2833,49,9,31040,706,721,721,711,10,4,6,711,393,318
"D0056","56","140","42045D0560000","42","045",462,462,62,400,0,0,106,105,105,105,0,0,0,105,21,84
"D0057","57","140","42045D0570000","42","045",5317,5317,1888,3427,2,24130,1449,1474,1474,1449,25,6,19,1449,573,876
"D0058","58","140","42045D0580000","42","045",10190,10190,6323,3863,4,23600,2478,2516,2516,2455,61,20,41,2455,838,1617
"D0059","59","140","42045D0590000","42","045",213,213,0,213,0,0,55,53,53,53,0,0,0,53,18,35
"D0060","60","140","42045D0600000","42","045",3291,3291,2418,871,2,21470,948,973,973,932,41,13,28,932,178,754
"D0061","61","140","42045D0610000","42","045",1637,1637,1637,0,0,42810,503,502,502,501,1,0,1,501,412,89
"D0062","62","140","42045D0620000","42","045",1042,1042,1040,2,0,0,288,289,289,288,1,0,1,288,222,66
"D0063","63","140","42045D0630000","42","045",4081,4081,3967,111,3,31840,1069,1098,1098,1065,33,23,10,1065,499,566
"D0064","64","140","42045D0640000","42","045",3547,3547,1080,2465,2,25240,820,839,839,824,15,11,4,824,298,526
"D0065","65","140","42045D0650000","42","045",2001,2001,2000,1,0,32500,550,566,566,549,17,14,3,549,390,159
"D0066","66","140","42045D0660000","42","045",3843,3843,3823,17,3,33900,1013,1025,1025,1013,12,7,5,1013,595,418
"D0067","67","140","42045D0670000","42","045",2938,2938,2777,161,0,33950,812,826,826,809,17,6,11,809,571,238
"D0068","68","140","42045D0680000","42","045",6997,6997,6149,847,1,36040,1820,1878,1878,1825,53,22,31,1825,1421,404
"D0069","69","140","42045D0690000","42","045",5576,5576,5557,19,0,36530,1427,1466,1466,1418,48,8,40,1418,1143,275
"D0070","70","140","42045D0700000","42","045",474,474,436,38,0,0,100,195,195,97,98,1,97,97,53,44
"D0071","71","140","42045D0710000","42","045",2009,2009,1971,38,0,40000,579,608,608,579,29,7,22,579,462,117
"D0072","72","140","42045D0720000","42","045",4029,4029,3805,223,1,25830,617,640,640,620,20,5,15,620,394,226
"D0073","73","140","42045D0730000","42","045",498,498,485,13,0,0,137,139,139,139,0,0,0,139,100,39
"D0074","74","140","42045D0740000","42","045",6173,6173,5646,527,0,43200,1622,1679,1679,1630,49,22,27,1630,1123,507
"D0075","75","140","42045D0750000","42","045",5726,5726,4986,737,3,34940,1715,1765,1765,1719,46,15,31,1719,1021,698
"D0076","76","140","42045D0760000","42","045",4825,4825,4625,188,12,28850,1244,1264,1264,1236,28,9,19,1236,839,397
"D0077","77","140","42045D0770000","42","045",1352,1352,591,761,0,0,314,321,321,314,7,3,4,314,225,89
"D0078","78","140","42045D0780000","42","045",10917,10917,10830,85,2,50680,2961,3040,3040,2953,87,42,45,2953,2688,265
"D0079","79","140","42045D0790000","42","045",3598,3598,3331,263,4,39220,1009,1071,1071,1002,69,32,37,1002,781,221
"D0080","80","140","42045D0800000","42","045",1605,1605,1562,42,1,0,473,506,506,473,33,13,20,473,384,89
"D0081","81","140","42045D0810000","42","045",3174,3174,3149,14,11,45450,901,923,923,900,23,8,15,900,779,121
"D0082","82","140","42045D0820000","42","045",1763,1763,1347,415,1,0,395,404,404,392,12,1,11,392,276,116
"D0083","83","140","42045D0830000","42","045",1909,1909,1805,102,2,18270,416,453,453,414,39,4,35,414,318,96
"D0084","84","140","42045D0840000","42","045",194,194,184,10,0,0,51,55,55,50,5,1,4,50,25,25
"D0085","85","140","42045D0850000","42","045",2299,2299,2298,0,1,47030,627,633,633,627,6,1,5,627,584,43
"D0086","86","140","42045D0860000","42","045",2215,2215,2210,5,0,50000,623,638,638,626,12,1,11,626,521,105
"D0087","87","140","42045D0870000","42","045",4237,4237,4221,15,1,54860,1206,1240,1240,1207,33,7,26,1207,1070,137
"D0088","88","140","42045D0880000","42","045",5740,5740,5519,218,3,42230,1525,1567,1567,1539,28,13,15,1539,1344,195
"D0089","89","140","42045D0890000","42","045",2940,2940,2936,4,0,58680,836,862,862,838,24,11,13,838,795,43
"D0090","90","140","42045D0900000","42","045",2191,2191,2188,3,0,46070,630,642,642,633,9,2,7,633,500,133
"D0091","91","140","42045D0910000","42","045",4773,4773,4770,3,0,53250,1360,1374,1374,1357,17,4,13,1357,1216,141
"D0092","92","140","42045D0920000","42","045",4474,4474,4471,3,0,44830,1204,1230,1230,1204,26,5,21,1204,1096,108
"D0093","93","140","42045D0930000","42","045",2184,2184,2176,3,5,54720,641,655,655,640,15,9,6,640,582,58
"D0094","94","140","42045D0940000","42","045",1833,1833,1832,0,1,56790,524,524,524,523,1,1,0,523,503,20
"D0095","95","140","42045D0950000","42","045",2889,2889,2880,7,2,56900,786,847,847,784,63,23,40,784,745,39
"D0096","96","140","42045D0960000","42","045",3740,3740,3447,291,2,35180,954,967,967,950,17,8,9,950,706,244
"D0097","97","140","42045D0970000","42","045",2934,2934,2870,59,5,7310,450,481,481,457,24,3,21,457,322,135
"D0098","98","140","42045D0980000","42","045",8035,8035,7699,332,4,36350,2289,2342,2342,2287,55,11,44,2287,1420,867
"D0099","99","140","42045D0990000","42","045",3518,3518,3465,53,0,38170,899,934,934,891,43,6,37,891,683,208
"D1000","1000","140","42045D1000000","42","045",1048,1048,945,102,1,0,203,240,240,204,36,3,33,204,123,81
"D1001","1001","140","42045D1010000","42","045",2101,2101,1387,714,0,12500,311,338,338,310,28,6,22,310,198,112
"D1002","1002","140","42045D1020000","42","045",836,836,746,89,1,0,230,242,242,231,11,2,9,231,117,114
"D1003","1003","140","42045D1030000","42","045",1945,1945,1766,179,0,31530,524,528,528,521,7,2,5,521,332,189
"D1004","1004","140","42045D1040000","42","045",1283,1283,1259,23,1,0,338,346,346,335,11,4,7,335,242,93
"M0001","1","140","42091M0010000","42","091",2245,2245,2140,105,0,35830,620,627,627,622,5,4,1,622,476,146
"M0002","2","140","42091M0020000","42","091",913,913,884,29,0,0,220,221,221,219,2,0,2,219,135,84
"M0003","3","140","42091M0030000","42","091",8936,8936,8781,144,11,36840,2561,2587,2587,2553,34,16,18,2553,2057,496
"M0004","4","140","42091M0040000","42","091",4788,4788,4778,10,0,37810,1392,1419,1419,1386,33,13,20,1386,1111,275
"M0005","5","140","42091M0050000","42","091",3663,3663,3591,72,0,32120,1073,1143,1143,1065,78,13,65,1065,809,256
"M0006","6","140","42091M0060000","42","091",1566,1566,1557,1,8,0,435,464,464,439,25,21,4,439,336,103
"M0007","7","140","42091M0070000","42","091",3101,3101,3094,7,0,34900,883,934,934,893,41,17,24,893,720,173
"M0008","8","140","42091M0080000","42","091",1624,1624,1623,0,1,0,451,461,461,448,13,7,6,448,301,147
"M0009","9","140","42091M0090000","42","091",9762,9762,9729,15,18,36310,2859,2909,2909,2858,51,31,20,2858,1939,919
"M0010","10","140","42091M0100000","42","091",2164,2164,2104,60,0,30830,598,626,626,600,26,14,12,600,440,160
"M0011","11","140","42091M0110000","42","091",2998,2998,2959,36,3,37340,871,879,879,869,10,3,7,869,593,276
"M0012","12","140","42091M0120000","42","091",2475,2475,1983,492,0,37270,658,691,691,662,29,5,24,662,472,190
"M0013","13","140","42091M0130000","42","091",4565,4565,3995,570,0,28230,1208,1214,1214,1207,7,4,3,1207,705,502
"M0014","14","140","42091M0140000","42","091",6637,6637,5754,880,3,39750,1650,1695,1695,1648,47,12,35,1648,1229,419
"M0015","15","140","42091M0150000","42","091",797,797,769,26,2,0,168,183,183,170,13,3,10,170,133,37
"M0016","16","140","42091M0160000","42","091",10764,10764,9277,1480,7,35050,2797,2852,2852,2795,57,14,43,2795,2373,422
"M0017","17","140","42091M0170000","42","091",10941,10941,10869,70,2,43350,3120,3160,3160,3114,46,18,28,3114,2702,412
"M0018","18","140","42091M0180000","42","091",1734,1734,1696,36,2,50000,535,538,538,535,3,3,0,535,353,182
"M0019","19","140","42091M0190000","42","091",4752,4752,4530,218,4,40170,1272,1280,1280,1261,19,7,12,1261,1141,120
"M0020","20","140","42091M0200000","42","091",2261,2261,2258,1,2,32650,696,717,717,694,23,9,14,694,532,162
"M0021","21","140","42091M0210000","42","091",5130,5130,4858,269,3,26630,1438,1439,1439,1415,24,9,15,1415,985,430
"M0022","22","140","42091M0220000","42","091",4557,4557,4550,4,3,42080,1250,1271,1271,1250,21,9,12,1250,1061,189
"M0023","23","140","42091M0230000","42","091",5114,5114,4971,141,2,55230,1465,1491,1491,1467,24,8,16,1467,1186,281
"M0024","24","140","42091M0240000","42","091",5349,5349,4718,630,1,51320,1584,1666,1666,1579,87,56,31,1579,1029,550
"M0025","25","140","42091M0250000","42","091",975,975,947,10,18,0,234,232,232,232,0,0,0,232,200,32
"M0026","26","140","42091M0260000","42","091",6859,6859,6716,140,3,46520,1868,1880,1880,1834,46,16,30,1834,1491,343
"M0027","27","140","42091M0270000","42","091",3996,3996,3993,2,1,45310,1102,1097,1097,1090,7,6,1,1090,1048,42
"M0028","28","140","42091M0280000","42","091",3385,3385,3373,12,0,39610,950,967,967,928,39,28,11,928,738,190
"M0029","29","140","42091M0290000","42","091",4022,4022,3991,31,0,43750,982,968,968,958,10,6,4,958,831,127
"M0030","30","140","42091M0300000","42","091",1328,1328,1318,10,0,0,357,364,364,355,9,2,7,355,217,138
"M0031","31","140","42091M0310000","42","091",4649,4649,4598,51,0,38650,1223,1240,1240,1216,24,5,19,1216,903,313
"M0032","32","140","42091M0320000","42","091",3063,3063,2775,288,0,29380,805,840,840,793,47,10,37,793,483,310
"M0033","33","140","42091M0330000","42","091",2987,2987,2830,157,0,40360,848,873,873,846,27,14,13,846,697,149
"M0034","34","140","42091M0340000","42","091",4879,4879,4777,101,1,34470,1095,1139,1139,1102,37,4,33,1102,867,235
"M0035","35","140","42091M0350000","42","091",3372,3372,2642,730,0,29580,771,774,774,773,1,1,0,773,496,277
"M0036","36","140","42091M0360000","42","091",8651,8651,7582,1068,1,31370,2259,2293,2293,2277,16,7,9,2277,1764,513
"M0037","37","140","42091M0370000","42","091",3589,3589,3374,213,2,0,22,19,19,19,0,0,0,19,5,14
"M0038","38","140","42091M0380000","42","091",11695,11695,11670,25,0,33260,3274,3365,3365,3333,32,18,14,3333,2092,1241
"M0039","39","140","42091M0390000","42","091",10819,10819,9759,1053,7,27030,2706,2729,2729,2681,48,24,24,2681,1295,1386
"M0040","40","140","42091M0400000","42","091",5118,5118,4956,162,0,35680,1288,1432,1432,1284,148,140,8,1284,972,312
"M0041","41","140","42091M0410000","42","091",10922,10922,10434,485,3,34110,2714,2717,2717,2686,31,17,14,2686,1961,725
"M0042","42","140","42091M0420000","42","091",2482,2482,2431,51,0,33680,584,594,594,582,12,6,6,582,415,167
"M0043","43","140","42091M0430000","42","091",2323,2323,2296,27,0,43750,670,657,657,656,1,1,0,656,418,238
"M0044","44","140","42091M0440000","42","091",3176,3176,3139,37,0,53440,899,902,902,897,5,3,2,897,725,172
"M0045","45","140","42091M0450000","42","091",4757,4757,4643,108,6,66940,1360,1382,1382,1357,25,15,10,1357,1007,350
"M0046","46","140","42091M0460000","42","091",3596,3596,3524,69,3,64500,936,963,963,933,30,10,20,933,849,84
"M0047","47","140","42091M0470000","42","091",3289,3289,3227,61,1,43410,807,834,834,808,26,10,16,808,626,182
"M0048","48","140","42091M0480000","42","091",2280,2280,2218,62,0,35630,548,563,563,541,22,8,14,541,379,162
"M0049","49","140","42091M0490000","42","091",1941,1941,1844,93,4,17260,405,417,417,401,16,9,7,401,286,115
"M0050","50","140","42091M0500000","42","091",2735,2735,2228,495,12,3990,544,540,540,534,6,5,1,534,252,282
"M0051","51","140","42091M0510000","42","091",2718,2718,2627,91,0,20970,734,737,737,724,13,8,5,724,351,373
"M0052","52","140","42091M0520000","42","091",2623,2623,2479,142,2,22730,824,854,854,817,37,8,29,817,443,374
"M0053","53","140","42091M0530000","42","091",2814,2814,2132,682,0,27190,738,751,751,740,11,9,2,740,349,391
"M0054","54","140","42091M0540000","42","091",5454,5454,5341,112,1,55830,1641,1667,1667,1644,23,14,9,1644,914,730
"M0055","55","140","42091M0550000","42","091",11039,11039,10328,707,4,42570,3143,3124,3124,3090,34,11,23,3090,2288,802
"M0056","56","140","42091M0560000","42","091",5407,5407,5388,18,1,45320,1713,1725,1725,1715,10,7,3,1715,1081,634
"M0057","57","140","42091M0570000","42","091",5827,5827,5781,46,0,26170,1306,1316,1316,1306,10,5,5,1306,875,431
"M0058","58","140","42091M0580000","42","091",3421,3421,3370,51,0,39380,842,862,862,845,17,1,16,845,577,268
"M0059","59","140","42091M0590000","42","091",2983,2983,2840,141,2,34170,723,796,796,720,76,10,66,720,495,225
"M0060","60","140","42091M0600000","42","091",5887,5887,5848,38,1,33360,1454,1599,1599,1452,147,45,102,1452,1061,391
"M0061","61","140","42091M0610000","42","091",4486,4486,4411,74,1,30740,1133,1172,1172,1130,42,7,35,1130,816,314
"M0062","62","140","42091M0620000","42","091",3862,3862,3861,1,0,35870,1160,1185,1185,1159,26,19,7,1159,760,399
"M0063","63","140","42091M0630000","42","091",1900,1900,1896,3,1,8450,363,375,375,360,15,1,14,360,214,146
"M0064","64","140","42091M0640000","42","091",773,773,772,1,0,0,230,245,245,230,15,3,12,230,163,67
"M0065","65","140","42091M0650000","42","091",1211,1211,1210,1,0,0,344,380,380,341,39,5,34,341,206,135
"M0066","66","140","42091M0660000","42","091",563,563,563,0,0,0,165,171,171,166,5,1,4,166,88,78
"M0067","67","140","42091M0670000","42","091",3843,3843,3018,824,1,31500,534,613,613,530,83,6,77,530,372,158
"M0068","68","140","42091M0680000","42","091",1939,1939,1929,10,0,0,546,543,543,540,3,2,1,540,392,148
"M0069","69","140","42091M0690000","42","091",1604,1604,1604,0,0,0,429,482,482,430,52,7,45,430,291,139
"M0070","70","140","42091M0700000","42","091",2290,2290,2290,0,0,27190,603,611,611,599,12,1,11,599,425,174
"M0071","71","140","42091M0710000","42","091",2774,2774,2770,4,0,31390,697,714,714,695,19,0,19,695,487,208
"M0072","72","140","42091M0720000","42","091",4521,4521,4516,3,2,37380,1360,1371,1371,1361,10,3,7,1361,948,413
"M0073","73","140","42091M0730000","42","091",1514,1514,1513,1,0,0,425,434,434,419,15,7,8,419,302,117
"M0074","74","140","42091M0740000","42","091",794,794,794,0,0,0,223,245,245,222,23,2,21,222,159,63
"M0075","75","140","42091M0750000","42","091",1119,1119,1109,10,0,0,317,348,348,317,31,3,28,317,222,95
"M0076","76","140","42091M0760000","42","091",1432,1432,1430,0,2,19170,364,383,383,361,22,6,16,361,242,119
"M0077","77","140","42091M0770000","42","091",550,550,549,1,0,0,149,149,149,147,2,1,1,147,90,57
"M0078","78","140","42091M0780000","42","091",1762,1762,1761,1,0,0,462,489,489,461,28,5,23,461,313,148
"M0079","79","140","42091M0790000","42","091",914,914,912,1,1,0,282,287,287,284,3,0,3,284,193,91
"M0080","80","140","42091M0800000","42","091",1625,1625,1625,0,0,29770,519,529,529,513,16,7,9,513,318,195
"M0081","81","140","42091M0810000","42","091",1945,1945,1944,0,1,33960,579,596,596,581,15,11,4,581,390,191
"M0082","82","140","42091M0820000","42","091",2046,2046,2046,0,0,28390,552,564,564,547,17,4,13,547,415,132
"M0083","83","140","42091M0830000","42","091",1745,1745,1737,8,0,31910,461,527,527,462,65,5,60,462,342,120
"M0084","84","140","42091M0840000","42","091",891,891,882,9,0,0,228,230,230,227,3,0,3,227,154,73
"M0085","85","140","42091M0850000","42","091",1620,1620,1619,1,0,0,437,545,545,429,116,3,113,429,290,139
"M0086","86","140","42091M0860000","42","091",3290,3290,3264,26,0,30730,871,892,892,865,27,6,21,865,611,254
"M0087","87","140","42091M0870000","42","091",3389,3389,3250,135,4,33170,964,1025,1025,965,60,10,50,965,564,401
"M0088","88","140","42091M0880000","42","091",5325,5325,5237,88,0,29220,1511,1514,1514,1508,6,1,5,1508,980,528
"M0089","89","140","42091M0890000","42","091",16248,16248,15603,644,1,33140,4865,4891,4891,4828,63,25,38,4828,3065,1763
"M0090","90","140","42091M0900000","42","091",1016,1016,904,112,0,0,255,260,260,253,7,2,5,253,109,144
"M0091","91","140","42091M0910000","42","091",1173,1173,1158,15,0,0,334,338,338,333,5,1,4,333,262,71
"M0092","92","140","42091M0920000","42","091",3007,3007,2914,93,0,31250,788,811,811,790,21,7,14,790,600,190
"0001A","1-A","140","4210100101000","42","101",589,589,582,7,0,0,140,147,147,140,7,1,6,140,61,79
"0001B","1-B","140","4210100102000","42","101",15014,15014,14823,185,6,27100,4097,4160,4160,4052,108,50,58,4052,2198,1854
"0001C","1-C","140","4210100103000","42","101",16890,16890,16703,183,4,28940,4356,4442,4442,4355,87,46,41,4355,2801,1554
"0002A","2-A","140","4210100201000","42","101",9323,9323,6346,2973,4,20860,2563,2608,2608,2554,54,21,33,2554,872,1682
"0002B","2-B","140","4210100202000","42","101",9413,9413,8614,795,4,24690,2436,2555,2555,2438,117,36,81,2438,1133,1305
"0002C","2-C","140","4210100203000","42","101",1616,1616,614,1002,0,14670,448,469,469,449,20,12,8,449,83,366
"0003A","3-A","140","4210100301000","42","101",10012,10012,7734,2276,2,21270,2861,2948,2948,2853,95,41,54,2853,938,1915
"0003B","3-B","140","4210100302000","42","101",2256,2256,573,1682,1,11250,610,670,670,608,62,2,60,608,112,496
"0004A","4-A","140","4210100401000","42","101",8075,8075,5558,2500,17,16320,2362,2403,2403,2341,62,23,39,2341,594,1747
"0004B","4-B","140","4210100402000","42","101",1979,1979,182,1794,3,6950,724,756,756,740,16,5,11,740,50,690
"0005A","5-A","140","4210100501000","42","101",6982,6982,5619,1354,9,18060,1893,1965,1965,1885,80,43,37,1885,364,1521
"0006A","6-A","140","4210100601000","42","101",1031,1031,743,286,2,10000,205,216,216,205,11,4,7,205,40,165
"0007A","7-A","140","4210100701000","42","101",5913,5913,5484,394,35,19950,2311,2444,2444,2303,141,91,50,2303,176,2127
"0007B","7-B","140","4210100702000","42","101",5469,5469,1180,4262,27,7740,1874,1899,1899,1874,25,11,14,1874,134,1740
"0007C","7-C","140","4210100703000","42","101",4171,4171,3993,174,4,27100,1883,2085,2085,1915,170,88,82,1915,452,1463
"0007D","7-D","140","4210100704000","42","101",6188,6188,2041,4124,23,16200,1750,1780,1780,1748,32,13,19,1748,295,1453
"0008A","8-A","140","4210100801000","42","101",2707,2707,2665,40,2,29230,1038,975,975,939,36,19,17,939,81,858
"0008B","8-B","140","4210100802000","42","101",9401,9401,8987,350,64,24550,3678,4005,4005,3670,335,164,171,3670,469,3201
"0009A","9-A","140","4210100901000","42","101",335,335,323,8,4,0,53,54,54,42,12,2,10,42,4,38
"0009B","9-B","140","4210100902000","42","101",1323,1323,1311,8,4,19380,426,412,412,395,17,12,5,395,47,348
"0010A","10-A","140","4210101001000","42","101",3838,3838,3178,305,355,9290,413,426,426,403,23,13,10,403,82,321
"0010B","10-B","140","4210101002000","42","101",4434,4434,4306,99,29,14920,960,1020,1020,959,61,28,33,959,166,793
"0011A","11-A","140","4210101101000","42","101",1986,1986,1536,448,2,19060,565,569,569,561,8,4,4,561,140,421
"0011B","11-B","140","4210101102000","42","101",968,968,520,447,1,0,269,299,299,270,29,1,28,270,41,229
"0012A","12-A","140","4210101201000","42","101",3823,3823,2709,1106,8,19670,1117,1153,1153,1109,44,13,31,1109,250,859
"0012B","12-B","140","4210101202000","42","101",2142,2142,1478,652,12,17830,546,566,566,544,22,15,7,544,150,394
"0013A","13-A","140","4210101301000","42","101",8006,8006,2662,5321,23,11990,2405,2490,2490,2368,122,38,84,2368,263,2105
"0013B","13-B","140","4210101302000","42","101",5300,5300,2734,2538,28,7530,1301,1369,1369,1304,65,36,29,1304,172,1132
"0014A","14-A","140","4210101401000","42","101",11853,11853,2596,9241,16,12120,3119,3237,3237,3130,107,62,45,3130,277,2853
"0014B","14-B","140","4210101402000","42","101",2322,2322,1941,363,18,14840,575,602,602,579,23,8,15,579,117,462
"0015A","15-A","140","4210101501000","42","101",16737,16737,14142,2550,45,18710,5522,5838,5838,5522,316,188,128,5522,874,4648
"0015B","15-B","140","4210101502000","42","101",2655,2655,2310,339,6,18940,739,794,794,743,51,8,43,743,112,631
"0015C","15-C","140","4210101503000","42","101",9726,9726,6584,3127,15,23280,2492,2569,2569,2455,114,34,80,2455,850,1605
"0015D","15-D","140","4210101504000","42","101",10764,10764,10693,63,8,31790,3179,3288,3288,3177,111,66,45,3177,1539,1638
"0015E","15-E","140","4210101505000","42","101",5,5,5,0,0,0,1,0,0,0,0,0,0,0,0,0
"0016A","16-A","140","4210101601000","42","101",7681,7681,6991,664,26,24390,2206,2327,2327,2203,124,34,90,2203,746,1457
"0017A","17-A","140","4210101701000","42","101",9635,9635,9331,283,21,23940,2773,2862,2862,2752,110,46,64,2752,943,1809
"0018A","18-A","140","4210101801000","42","101",4253,4253,4249,2,2,27290,1169,1202,1202,1157,45,23,22,1157,617,540
"0018B","18-B","140","4210101802000","42","101",6729,6729,6722,2,5,30300,1839,1875,1875,1831,44,22,22,1831,1051,780
"0018C","18-C","140","4210101803000","42","101",3943,3943,3940,0,3,24170,1056,1095,1095,1059,36,8,28,1059,662,397
"0018D","18-D","140","4210101804000","42","101",3772,3772,3771,0,1,33100,978,1032,1032,984,48,14,34,984,708,276
"0019A","19-A","140","4210101901000","42","101",17287,17287,16416,843,28,25440,4807,4996,4996,4869,127,60,67,4869,2515,2354
"0019B","19-B","140","4210101902000","42","101",10554,10554,10394,157,3,28670,3168,3263,3263,3175,88,46,42,3175,1693,1482
"0019C","19-C","140","4210101903000","42","101",11874,11874,11689,172,13,27160,3303,3441,3441,3304,137,43,94,3304,1732,1572
"0020A","20-A","140","4210102001000","42","101",15427,15427,11380,3935,112,22800,4666,4890,4890,4673,217,132,85,4673,1255,3418
"0020B","20-B","140","4210102002000","42","101",12835,12835,641,12182,12,13160,3616,3785,3785,3633,152,67,85,3633,465,3168
"0020C","20-C","140","4210102003000","42","101",3461,3461,873,2581,7,15170,1158,1243,1243,1186,57,41,16,1186,157,1029
"0020D","20-D","140","4210102004000","42","101",12121,12121,5242,6861,18,19970,3564,3715,3715,3562,153,73,80,3562,646,2916
"0021A","21-A","140","4210102101000","42","101",1405,1405,1396,8,1,59640,667,667,667,662,5,3,2,662,62,600
"0021B","21-B","140","4210102102000","42","101",1372,1372,1338,33,1,0,387,423,423,388,35,17,18,388,251,137
"0021C","21-C","140","4210102103000","42","101",51,51,51,0,0,0,14,10,10,10,0,0,0,10,0,10
"0021D","21-D","140","4210102104000","42","101",663,663,658,1,4,0,182,190,190,181,9,7,2,181,167,14
"0021E","21-E","140","4210102105000","42","101",319,319,313,6,0,0,87,91,91,90,1,0,1,90,58,32
"0021F","21-F","140","4210102106000","42","101",228,228,227,1,0,0,66,71,71,65,6,5,1,65,31,34
"0021G","21-G","140","4210102107000","42","101",401,401,398,3,0,0,113,121,121,113,8,6,2,113,72,41
"0021H","21-H","140","4210102108000","42","101",146,146,135,11,0,0,33,39,39,34,5,1,4,34,11,23
"0021I","21-I","140","4210102109000","42","101",160,160,160,0,0,0,40,46,46,42,4,0,4,42,32,10
"0021J","21-J","140","4210102110000","42","101",641,641,641,0,0,0,182,186,186,182,4,2,2,182,147,35
"0021K","21-K","140","4210102111000","42","101",231,231,231,0,0,0,61,62,62,59,3,1,2,59,50,9
"0021L","21-L","140","4210102112000","42","101",140,140,139,0,1,0,40,41,41,40,1,0,1,40,26,14
"0021M","21-M","140","4210102113000","42","101",327,327,327,0,0,0,85,90,90,84,6,4,2,84,61,23
"0021N","21-N","140","4210102114000","42","101",3478,3478,3416,62,0,30420,851,856,856,843,13,7,6,843,591,252
"0021O","21-O","140","4210102115000","42","101",1590,1590,1590,0,0,0,451,453,453,449,4,4,0,449,340,109
"0021P","21-P","140","4210102116000","42","101",2288,2288,2286,1,1,38880,608,625,625,620,5,2,3,620,571,49
"0021Q","21-Q","140","4210102117000","42","101",2280,2280,2264,15,1,33610,654,654,654,646,8,5,3,646,520,126
"0021R","21-R","140","4210102118000","42","101",4711,4711,4620,90,1,36170,1296,1328,1328,1300,28,13,15,1300,929,371
"0021S","21-S","140","4210102119000","42","101",6750,6750,6162,588,0,29650,1695,1745,1745,1707,38,13,25,1707,1144,563
"0021T","21-T","140","4210102120000","42","101",7454,7454,7321,132,1,32080,1865,1902,1902,1872,30,17,13,1872,1446,426
"0021U","21-U","140","4210102121000","42","101",1888,1888,1887,1,0,39840,528,543,543,531,12,8,4,531,411,120
"0021V","21-V","140","4210102122000","42","101",4886,4886,4876,10,0,34190,1322,1345,1345,1322,23,18,5,1322,870,452
"0022A","22-A","140","4210102201000","42","101",5796,5796,5217,578,1,36290,1483,1501,1501,1485,16,7,9,1485,1200,285
"0022B","22-B","140","4210102202000","42","101",657,657,653,4,0,0,151,162,162,153,9,9,0,153,125,28
"0022C","22-C","140","4210102203000","42","101",1374,1374,1370,2,2,0,369,428,428,372,56,52,4,372,276,96
"0022D","22-D","140","4210102204000","42","101",3519,3519,3511,8,0,48210,1190,1339,1339,1199,140,133,7,1199,752,447
"0022E","22-E","140","4210102205000","42","101",3255,3255,3241,14,0,41360,1015,1026,1026,1009,17,7,10,1009,710,299
"0022F","22-F","140","4210102206000","42","101",3083,3083,3073,8,2,52290,891,901,901,887,14,4,10,887,707,180
"0022G","22-G","140","4210102207000","42","101",2259,2259,2256,3,0,36040,631,677,677,626,51,42,9,626,376,250
"0022H","22-H","140","4210102208000","42","101",1877,1877,1867,9,1,31670,556,565,565,553,12,7,5,553,376,177
"0022I","22-I","140","4210102209000","42","101",908,908,865,39,4,0,146,150,150,138,12,6,6,138,108,30
"0022J","22-J","140","4210102210000","42","101",671,671,667,2,2,3170,52,54,54,53,1,1,0,53,47,6
"0022K","22-K","140","4210102211000","42","101",3,3,3,0,0,0,1,0,0,0,0,0,0,0,0,0
"0022L","22-L","140","4210102212000","42","101",0,0,0,0,0,0,0,0,0,0,0,0,0,0,0,0
"0022M","22-M","140","4210102213000","42","101",43,43,43,0,0,0,6,6,6,6,0,0,0,6,3,3
"0022N","22-N","140","4210102214000","42","101",164,164,161,3,0,0,34,35,35,33,2,0,2,33,21,12
"0022O","22-O","140","4210102215000","42","101",1157,1157,1125,32,0,0,357,353,353,345,8,3,5,345,220,125
"0022P","22-P","140","4210102216000","42","101",1706,1706,1653,53,0,31880,445,454,454,444,10,4,6,444,233,211
"0022Q","22-Q","140","4210102217000","42","101",53,53,53,0,0,0,18,18,18,18,0,0,0,18,9,9
"0022R","22-R","140","4210102218000","42","101",1196,1196,1147,49,0,0,180,170,170,170,0,0,0,170,120,50
"0022S","22-S","140","4210102219000","42","101",22,22,22,0,0,0,5,5,5,5,0,0,0,5,1,4
"0022T","22-T","140","4210102220000","42","101",531,531,520,11,0,0,161,173,173,158,15,13,2,158,148,10
"0022U","22-U","140","4210102221000","42","101",4556,4556,4528,22,6,40380,1351,1430,1430,1343,87,68,19,1343,989,354
"0022V","22-V","140","4210102222000","42","101",2184,2184,2165,19,0,43250,669,678,678,660,18,12,6,660,357,303
"0022W","22-W","140","4210102223000","42","101",2508,2508,2471,35,2,49000,757,774,774,761,13,9,4,761,513,248
"0022X","22-X","140","4210102224000","42","101",4077,4077,3357,716,4,41170,1250,1272,1272,1246,26,11,15,1246,475,771
"0022Y","22-Y","140","4210102225000","42","101",6727,6727,4524,2194,9,31980,1876,1901,1901,1869,32,21,11,1869,1327,542
"0022Z","22-Z","140","4210102226000","42","101",9502,9502,8989,499,14,33510,2944,3022,3022,2940,82,55,27,2940,1808,1132
"0022AA","22-AA","140","4210102227000","42","101",5919,5919,4819,1091,9,32950,2149,2222,2222,2157,65,23,42,2157,885,1272
"0022BB","22-BB","140","4210102228000","42","101",2038,2038,2009,29,0,41590,821,834,834,822,12,4,8,822,216,606
"0022CC","22-CC","140","4210102229000","42","101",2496,2496,2399,97,0,34260,936,947,947,937,10,5,5,937,298,639
"0022DD","22-DD","140","4210102230000","42","101",2012,2012,1408,601,3,24200,581,580,580,572,8,1,7,572,196,376
"0022EE","22-EE","140","4210102231000","42","101",6884,6884,4944,1938,2,23380,1821,1844,1844,1808,36,19,17,1808,811,997
"0022FF","22-FF","140","4210102232000","42","101",3538,3538,3278,260,0,38250,954,959,959,950,9,6,3,950,738,212
"0022GG","22-GG","140","4210102233000","42","101",7432,7432,7167,262,3,31000,1811,1863,1863,1809,54,19,35,1809,1172,637
"0022HH","22-HH","140","4210102234000","42","101",7208,7208,6162,1044,2,27550,2043,2096,2096,2045,51,20,31,2045,1281,764
"0022II","22-II","140","4210102235000","42","101",7948,7948,6535,1403,10,28610,2656,2684,2684,2648,36,12,24,2648,1348,1300
"0022JJ","22-JJ","140","4210102236000","42","101",5700,5700,5686,10,4,31010,1800,1842,1842,1795,47,25,22,1795,1028,767
"0022KK","22-KK","140","4210102237000","42","101",5194,5194,4721,468,5,35770,1713,1767,1767,1722,45,32,13,1722,1012,710
"0023A","23-A","140","4210102301000","42","101",1164,1164,1162,2,0,0,314,323,323,318,5,1,4,318,219,99
"0023B","23-B","140","4210102302000","42","101",4661,4661,4659,0,2,36820,1366,1373,1373,1363,10,1,9,1363,1060,303
"0023C","23-C","140","4210102303000","42","101",1667,1667,1665,2,0,0,492,494,494,491,3,3,0,491,404,87
"0023D","23-D","140","4210102304000","42","101",7549,7549,7540,4,5,39600,2370,2399,2399,2367,32,16,16,2367,1855,512
"0023E","23-E","140","4210102305000","42","101",6246,6246,6234,9,3,35970,2216,2272,2272,2212,60,34,26,2212,1165,1047
"0023F","23-F","140","4210102306000","42","101",4841,4841,4811,29,1,27680,1377,1406,1406,1383,23,8,15,1383,834,549
"0023G","23-G","140","4210102307000","42","101",8104,8104,6730,1368,6,27180,2507,2563,2563,2506,57,30,27,2506,1357,1149
"0023H","23-H","140","4210102308000","42","101",5214,5214,5198,15,1,33820,1487,1499,1499,1485,14,9,5,1485,1121,364
"0023I","23-I","140","4210102309000","42","101",5837,5837,5640,195,2,28210,1688,1740,1740,1695,45,11,34,1695,916,779
"0023J","23-J","140","4210102310000","42","101",1765,1765,724,1038,3,0,428,433,433,429,4,1,3,429,124,305
"0023K","23-K","140","4210102311000","42","101",4791,4791,4787,1,3,30540,1277,1317,1317,1288,29,11,18,1288,995,293
"0024A","24-A","140","4210102401000","42","101",609,609,608,1,0,0,46,49,49,46,3,3,0,46,17,29
"0024B","24-B","140","4210102402000","42","101",10195,10195,9063,1130,2,25950,3187,3274,3274,3160,114,80,34,3160,1209,1951
"0024C","24-C","140","4210102403000","42","101",14282,14282,3856,10402,24,20070,3764,3846,3846,3747,99,63,36,3747,1412,2335
"0024D","24-D","140","4210102404000","42","101",13596,13596,1888,11698,10,20270,3302,3400,3400,3322,78,29,49,3322,1068,2254
"0024E","24-E","140","4210102405000","42","101",5798,5798,2320,3473,5,21850,1463,1543,1543,1475,68,35,33,1475,417,1058
"0024F","24-F","140","4210102406000","42","101",13588,13588,7927,5619,42,17980,4148,4327,4327,4134,193,129,64,4134,779,3355
"0024G","24-G","140","4210102407000","42","101",5323,5323,896,4418,9,17870,1580,1617,1617,1572,45,16,29,1572,485,1087
"0025A","25-A","140","4210102501000","42","101",10692,10692,10681,1,10,28850,3151,3246,3246,3135,111,64,47,3135,1815,1320
"0025B","25-B","140","4210102502000","42","101",10665,10665,10192,468,5,33240,2741,2784,2784,2736,48,23,25,2736,2085,651
"0025C","25-C","140","4210102503000","42","101",14568,14568,14547,5,16,32480,3762,3818,3818,3759,59,28,31,3759,2867,892
"0025D","25-D","140","4210102504000","42","101",1136,1136,1119,11,6,0,262,267,267,262,5,3,2,262,176,86
"0026A","26-A","140","4210102601000","42","101",2809,2809,576,2228,5,16500,835,853,853,836,17,6,11,836,270,566
"0026B","26-B","140","4210102602000","42","101",7677,7677,6388,1285,4,24920,2047,2103,2103,2059,44,25,19,2059,956,1103
"0026C","26-C","140","4210102603000","42","101",9070,9070,8562,506,2,32920,2251,2300,2300,2260,40,20,20,2260,1430,830
"0026D","26-D","140","4210102604000","42","101",13621,13621,11577,2033,11,29970,3572,3628,3628,3549,79,53,26,3549,2209,1340
"0026E","26-E","140","4210102605000","42","101",19192,19192,19171,9,12,31530,5062,5138,5138,5072,66,37,29,5072,3432,1640
"0026F","26-F","140","4210102606000","42","101",4148,4148,1478,2668,2,24080,861,874,874,863,11,4,7,863,173,690
"0027A","27-A","140","4210102701000","42","101",3989,3989,3329,604,56,15410,994,1060,1060,1001,59,31,28,1001,158,843
"0027B","27-B","140","4210102702000","42","101",9499,9499,8391,1028,80,17260,3239,3379,3379,3248,131,83,48,3248,415,2833
"0027C","27-C","140","4210102703000","42","101",9443,9443,8988,434,21,26900,3853,3934,3934,3833,101,65,36,3833,637,3196
"0027D","27-D","140","4210102704000","42","101",3045,3045,1731,1307,7,22680,1039,1083,1083,1046,37,18,19,1046,158,888
"0027E","27-E","140","4210102705000","42","101",4094,4094,3344,737,13,3560,25,25,25,25,0,0,0,25,20,5
"0028A","28-A","140","4210102801000","42","101",11903,11903,6896,4956,51,24320,3416,3507,3507,3395,112,59,53,3395,1865,1530
"0028B","28-B","140","4210102802000","42","101",11584,11584,2654,8916,14,22520,3104,3184,3184,3116,68,24,44,3116,1530,1586
"0028C","28-C","140","4210102803000","42","101",16604,16604,12607,3979,18,26510,4762,4861,4861,4755,106,57,49,4755,2619,2136
"0028D","28-D","140","4210102804000","42","101",6660,6660,6657,1,2,30500,2121,2155,2155,2113,42,12,30,2113,1275,838
"0028E","28-E","140","4210102805000","42","101",4024,4024,1827,2188,9,23350,1296,1338,1338,1296,42,23,19,1296,477,819
"0029A","29-A","140","4210102901000","42","101",11800,11800,6029,5760,11,21500,3513,3628,3628,3521,107,65,42,3521,1552,1969
"0029B","29-B","140","4210102902000","42","101",13,13,13,0,0,0,4,5,5,5,0,0,0,5,0,5
"0029C","29-C","140","4210102903000","42","101",10188,10188,9697,488,3,30000,3040,3143,3143,3052,91,38,53,3052,1780,1272
"0029D","29-D","140","4210102904000","42","101",8332,8332,1984,6346,2,20350,2067,2131,2131,2077,54,34,20,2077,837,1240
"0030A","30-A","140","4210103001000","42","101",16515,16515,519,15969,27,12980,5221,5281,5281,5206,75,24,51,5206,853,4353
"0030B","30-B","140","4210103002000","42","101",10693,10693,2843,7820,30,15040,2842,2865,2865,2840,25,7,18,2840,970,1870
"0031A","31-A","140","4210103101000","42","101",11840,11840,11822,5,13,26750,3425,3589,3589,3439,150,68,82,3439,1778,1661
"0031B","31-B","140","4210103102000","42","101",9071,9071,9063,1,7,30540,2461,2543,2543,2456,87,40,47,2456,1685,771
"0031C","31-C","140","4210103103000","42","101",3297,3297,3297,0,0,31480,866,896,896,870,26,13,13,870,644,226
"0032A","32-A","140","4210103201000","42","101",9571,9571,260,9303,8,16530,2935,3059,3059,2950,109,38,71,2950,289,2661
"0032B","32-B","140","4210103202000","42","101",3448,3448,2156,1284,8,10680,1063,1108,1108,1061,47,44,3,1061,80,981
"0032C","32-C","140","4210103203000","42","101",14351,14351,2301,12028,22,19750,4770,4933,4933,4773,160,86,74,4773,931,3842
"0032D","32-D","140","4210103204000","42","101",15678,15678,224,15443,11,17800,4563,4756,4756,4589,167,82,85,4589,1112,3477
"0032E","32-E","140","4210103205000","42","101",17799,17799,10967,6814,18,24550,5293,5383,5383,5244,139,87,52,5244,2170,3074
"0032F","32-F","140","4210103206000","42","101",13,13,13,0,0,0,4,4,4,4,0,0,0,4,0,4
"0033A","33-A","140","4210103301000","42","101",2,2,2,0,0,0,1,0,0,0,0,0,0,0,0,0
"0033B","33-B","140","4210103302000","42","101",7906,7906,7892,3,11,37170,2288,2296,2296,2278,18,4,14,2278,1568,710
"0033C","33-C","140","4210103303000","42","101",4651,4651,4646,4,1,36760,1324,1403,1403,1326,77,32,45,1326,1097,229
"0033D","33-D","140","4210103304000","42","101",496,496,496,0,0,0,139,142,142,139,3,0,3,139,33,106
"0033E","33-E","140","4210103305000","42","101",609,609,492,116,1,0,46,46,46,45,1,0,1,45,36,9
"0033F","33-F","140","4210103306000","42","101",3333,3333,3317,16,0,32140,988,1002,1002,983,19,11,8,983,691,292
"0033G","33-G","140","4210103307000","42","101",11127,11127,11107,11,9,31550,3251,3290,3290,3240,50,21,29,3240,2321,919
"0033H","33-H","140","4210103308000","42","101",8700,8700,8696,3,1,32410,2466,2480,2480,2446,34,13,21,2446,1809,637
"0033I","33-I","140","4210103309000","42","101",14555,14555,14527,6,22,30750,4176,4256,4256,4162,94,30,64,4162,2792,1370
"0033J","33-J","140","4210103310000","42","101",13157,13157,13136,13,8,31410,3795,3851,3851,3783,68,26,42,3783,2623,1160
"0033K","33-K","140","4210103311000","42","101",2392,2392,2381,1,10,28750,743,772,772,751,21,10,11,751,408,343
"0034A","34-A","140","4210103401000","42","101",3130,3130,3100,29,1,50190,760,786,786,762,24,22,2,762,428,334
"0034B","34-B","140","4210103402000","42","101",1658,1658,1601,57,0,0,462,471,471,462,9,8,1,462,327,135
"0034C","34-C","140","4210103403000","42","101",1923,1923,1907,15,1,56250,511,518,518,510,8,6,2,510,354,156
"0034D","34-D","140","4210103404000","42","101",3512,3512,3503,8,1,50630,984,994,994,978,16,13,3,978,833,145
"0034E","34-E","140","4210103405000","42","101",4833,4833,4820,11,2,48750,1313,1327,1327,1311,16,14,2,1311,1179,132
"0034F","34-F","140","4210103406000","42","101",7329,7329,7310,19,0,38110,2102,2148,2148,2108,40,20,20,2108,1450,658
"0034G","34-G","140","4210103407000","42","101",12,12,12,0,0,0,2,0,0,0,0,0,0,0,0,0
"0034H","34-H","140","4210103408000","42","101",15849,15849,10889,4940,20,31010,4247,4266,4266,4233,33,19,14,4233,3130,1103
"0034I","34-I","140","4210103409000","42","101",20283,20283,17212,3057,14,33150,6054,6086,6086,6027,59,28,31,6027,3990,2037
"0034J","34-J","140","4210103410000","42","101",3698,3698,3653,41,4,37030,1116,1116,1116,1101,15,6,9,1101,566,535
"0034K","34-K","140","4210103411000","42","101",279,279,274,5,0,0,64,66,66,63,3,2,1,63,61,2
"0034L","34-L","140","4210103412000","42","101",0,0,0,0,0,0,0,0,0,0,0,0,0,0,0,0
"0034M","34-M","140","4210103413000","42","101",12784,12784,12773,7,4,36000,3210,3256,3256,3225,31,11,20,3225,2672,553
"0034N","34-N","140","4210103414000","42","101",6471,6471,6448,21,2,46470,1885,1903,1903,1883,20,7,13,1883,1797,86
"0034O","34-O","140","4210103415000","42","101",0,0,0,0,0,0,0,0,0,0,0,0,0,0,0,0
"0034P","34-P","140","4210103416000","42","101",13040,13040,6367,6644,29,25520,3526,3552,3552,3502,50,28,22,3502,2379,1123
"0034Q","34-Q","140","4210103417000","42","101",12266,12266,1444,10813,9,21320,3352,3393,3393,3357,36,15,21,3357,2034,1323
"0035A","35-A","140","4210103501000","42","101",240,240,217,23,0,0,44,46,46,40,6,2,4,40,34,6
"0035B","35-B","140","4210103502000","42","101",132,132,131,1,0,0,38,39,39,38,1,1,0,38,22,16
"0035C","35-C","140","4210103503000","42","101",6015,6015,4728,1280,7,0,7,7,7,7,0,0,0,7,4,3
"0035D","35-D","140","4210103504000","42","101",516,516,514,0,2,0,147,156,156,145,11,5,6,145,106,39
"0035E","35-E","140","4210103505000","42","101",822,822,822,0,0,0,251,266,266,250,16,6,10,250,213,37
"0035F","35-F","140","4210103506000","42","101",10,10,10,0,0,0,3,3,3,3,0,0,0,3,2,1
"0035G","35-G","140","4210103507000","42","101",356,356,355,1,0,0,107,117,117,108,9,1,8,108,59,49
"0035H","35-H","140","4210103508000","42","101",29,29,24,5,0,0,6,7,7,6,1,0,1,6,3,3
"0035I","35-I","140","4210103509000","42","101",109,109,109,0,0,0,31,32,32,32,0,0,0,32,25,7
"0035J","35-J","140","4210103510000","42","101",5213,5213,5195,14,4,31030,1346,1353,1353,1347,6,2,4,1347,12,1335
"0035K","35-K","140","4210103511000","42","101",323,323,323,0,0,0,90,91,91,88,3,0,3,88,74,14
"0035L","35-L","140","4210103512000","42","101",221,221,210,11,0,0,60,60,60,60,0,0,0,60,47,13
"0035M","35-M","140","4210103513000","42","101",81,81,78,1,2,0,20,23,23,20,3,0,3,20,2,18
"0035N","35-N","140","4210103514000","42","101",380,380,379,1,0,0,105,117,117,103,14,0,14,103,86,17
"0035O","35-O","140","4210103515000","42","101",146,146,146,0,0,0,44,49,49,45,4,3,1,45,41,4
"0035P","35-P","140","4210103516000","42","101",181,181,181,0,0,0,53,57,57,53,4,1,3,53,48,5
"0035Q","35-Q","140","4210103517000","42","101",1279,1279,1279,0,0,0,380,387,387,379,8,2,6,379,291,88
"0035R","35-R","140","4210103518000","42","101",159,159,159,0,0,0,45,45,45,44,1,1,0,44,28,16
"0035S","35-S","140","4210103519000","42","101",5290,5290,5129,161,0,37120,1295,1307,1307,1293,14,9,5,1293,298,995
"0035T","35-T","140","4210103520000","42","101",277,277,144,133,0,0,69,79,79,71,8,2,6,71,60,11
"0035U","35-U","140","4210103521000","42","101",218,218,218,0,0,0,65,69,69,65,4,1,3,65,40,25
"0035V","35-V","140","4210103522000","42","101",100,100,100,0,0,0,9,11,11,11,0,0,0,11,0,11
"0035W","35-W","140","4210103523000","42","101",1003,1003,994,7,2,0,155,161,161,154,7,1,6,154,134,20
"0035X","35-X","140","4210103524000","42","101",117,117,115,0,2,0,15,17,17,17,0,0,0,17,12,5
"0035Y","35-Y","140","4210103525000","42","101",1690,1690,1687,2,1,38330,479,496,496,485,11,8,3,485,402,83
"0035Z","35-Z","140","4210103526000","42","101",1964,1964,1964,0,0,42340,576,592,592,584,8,1,7,584,424,160
"0035AA","35-AA","140","4210103527000","42","101",561,561,561,0,0,0,172,184,184,171,13,11,2,171,150,21
"0035BB","35-BB","140","4210103528000","42","101",53,53,53,0,0,0,18,22,22,18,4,3,1,18,14,4
"0035CC","35-CC","140","4210103529000","42","101",1336,1336,1336,0,0,0,368,370,370,367,3,0,3,367,302,65
"0035DD","35-DD","140","4210103530000","42","101",1514,1514,1514,0,0,0,433,443,443,435,8,7,1,435,397,38
"0035EE","35-EE","140","4210103531000","42","101",539,539,538,1,0,0,164,168,168,165,3,0,3,165,140,25
"0035FF","35-FF","140","4210103532000","42","101",3268,3268,3263,5,0,40760,897,906,906,888,18,2,16,888,757,131
"0035GG","35-GG","140","4210103533000","42","101",6262,6262,6259,3,0,39620,1845,1856,1856,1836,20,15,5,1836,1598,238
"0035HH","35-HH","140","4210103534000","42","101",1393,1393,1393,0,0,0,357,382,382,356,26,26,0,356,226,130
"0035II","35-II","140","4210103535000","42","101",303,303,302,1,0,0,103,101,101,101,0,0,0,101,92,9
"0035JJ","35-JJ","140","4210103536000","42","101",1116,1116,1116,0,0,0,311,318,318,308,10,0,10,308,281,27
"0035KK","35-KK","140","4210103537000","42","101",3676,3676,3676,0,0,37710,1116,1130,1130,1122,8,3,5,1122,914,208
"0035LL","35-LL","140","4210103538000","42","101",925,925,925,0,0,0,272,280,280,274,6,4,2,274,199,75
"0035MM","35-MM","140","4210103539000","42","101",281,281,262,19,0,0,59,58,58,58,0,0,0,58,54,4
"0035NN","35-NN","140","4210103540000","42","101",2285,2285,2285,0,0,43440,688,694,694,687,7,2,5,687,506,181
"0035OO","35-OO","140","4210103541000","42","101",1667,1667,1667,0,0,0,488,502,502,489,13,11,2,489,447,42
"0035PP","35-PP","140","4210103542000","42","101",3266,3266,3264,2,0,44310,938,954,954,935,19,8,11,935,820,115
"0035QQ","35-QQ","140","4210103543000","42","101",6987,6987,6978,3,6,41830,2080,2418,2418,2084,334,300,34,2084,1788,296
"0035RR","35-RR","140","4210103544000","42","101",11756,11756,11753,1,2,42870,3387,3410,3410,3358,52,27,25,3358,2753,605
"0035SS","35-SS","140","4210103545000","42","101",5364,5364,5363,1,0,39290,1530,1536,1536,1529,7,4,3,1529,1350,179
"0035TT","35-TT","140","4210103546000","42","101",10358,10358,10346,12,0,42770,3025,3049,3049,3001,48,12,36,3001,2409,592
"0035UU","35-UU","140","4210103547000","42","101",7799,7799,7792,4,3,43470,2237,2326,2326,2234,92,71,21,2234,1903,331
"0035VV","35-VV","140","4210103548000","42","101",6101,6101,6100,1,0,39320,1739,1750,1750,1730,20,9,11,1730,1281,449
"0035WW","35-WW","140","4210103549000","42","101",4111,4111,4111,0,0,41770,1193,1201,1201,1188,13,0,13,1188,1020,168
"0035XX","35-XX","140","4210103550000","42","101",6743,6743,6738,2,3,38490,1954,1992,1992,1953,39,31,8,1953,1501,452
"0035YY","35-YY","140","4210103551000","42","101",14729,14729,14710,4,15,36510,3895,3852,3852,3819,33,9,24,3819,2593,1226
"0035ZZ","35-ZZ","140","4210103552000","42","101",5260,5260,5258,2,0,45330,1536,1598,1598,1548,50,39,11,1548,1256,292
"0035AAA","35-AAA","140","4210103553000","42","101",4820,4820,4818,0,2,38450,1304,1559,1559,1317,242,55,187,1317,1169,148
"0035BBB","35-BBB","140","4210103554000","42","101",845,845,845,0,0,0,270,285,285,271,14,7,7,271,153,118
"0035CCC","35-CCC","140","4210103555000","42","101",4210,4210,4205,3,2,37210,1167,1171,1171,1165,6,2,4,1165,740,425
"0035DDD","35-DDD","140","4210103556000","42","101",2743,2743,2741,2,0,40130,669,658,658,657,1,1,0,657,505,152
"0035EEE","35-EEE","140","4210103557000","42","101",1316,1316,1315,1,0,0,408,413,413,406,7,4,3,406,360,46
"0036A","36-A","140","4210103601000","42","101",2632,2632,78,2551,3,15830,811,822,822,815,7,1,6,815,286,529
"0036B","36-B","140","4210103602000","42","101",14445,14445,4284,10067,94,21250,3857,3889,3889,3828,61,21,40,3828,1684,2144
"0036C","36-C","140","4210103603000","42","101",16413,16413,10288,6104,21,26770,3944,3983,3983,3930,53,29,24,3930,2335,1595
"0036D","36-D","140","4210103604000","42","101",13412,13412,11957,1445,10,32760,3266,3329,3329,3269,60,28,32,3269,2077,1192
"0036E","36-E","140","4210103605000","42","101",5884,5884,3415,2456,13,21840,1432,1454,1454,1433,21,17,4,1433,261,1172
"0037A","37-A","140","4210103701000","42","101",2620,2620,2562,54,4,21980,763,761,761,737,24,9,15,737,282,455
"0037B","37-B","140","4210103702000","42","101",7046,7046,7037,2,7,26100,2247,2281,2281,2209,72,37,35,2209,1217,992
"0037C","37-C","140","4210103703000","42","101",1358,1358,1090,262,6,22120,410,417,417,403,14,10,4,403,133,270
"0037D","37-D","140","4210103704000","42","101",2977,2977,1240,1696,41,18960,783,810,810,782,28,20,8,782,318,464
"0037E","37-E","140","4210103705000","42","101",703,703,405,297,1,0,230,232,232,232,0,0,0,232,42,190
"0037F","37-F","140","4210103706000","42","101",6900,6900,4828,2061,11,23110,2162,2229,2229,2162,67,45,22,2162,975,1187
"0038A","38-A","140","4210103801000","42","101",8298,8298,8197,94,7,31600,2273,2315,2315,2280,35,19,16,2280,1026,1254
"0038B","38-B","140","4210103802000","42","101",528,528,224,304,0,0,118,121,121,120,1,0,1,120,91,29
"0038C","38-C","140","4210103803000","42","101",1247,1247,1228,15,4,65710,391,394,394,389,5,4,1,389,219,170
"0038D","38-D","140","4210103804000","42","101",2935,2935,2922,8,5,33100,786,799,799,785,14,6,8,785,602,183
"0038E","38-E","140","4210103805000","42","101",4997,4997,4978,2,17,34500,1454,1478,1478,1455,23,11,12,1455,956,499
"0038F","38-F","140","4210103806000","42","101",9708,9708,9697,4,7,34340,2561,2618,2618,2577,41,26,15,2577,2009,568
"0038G","38-G","140","4210103807000","42","101",11611,11611,10274,1333,4,27420,3747,3890,3890,3751,139,75,64,3751,1611,2140
"0038H","38-H","140","4210103808000","42","101",16468,16468,12391,4020,57,23310,5292,5435,5435,5261,174,96,78,5261,2264,2997
"0038I","38-I","140","4210103809000","42","101",6557,6557,6294,260,3,32420,1818,1873,1873,1821,52,21,31,1821,1108,713
"0038J","38-J","140","4210103810000","42","101",13797,13797,13694,92,11,33510,3814,3859,3859,3820,39,18,21,3820,3019,801
"0038K","38-K","140","4210103811000","42","101",370,370,370,0,0,0,96,96,96,93,3,3,0,93,0,93
"0039A","39-A","140","4210103901000","42","101",0,0,0,0,0,0,0,0,0,0,0,0,0,0,0,0
"0039B","39-B","140","4210103902000","42","101",17703,17703,17293,402,8,31840,4658,4697,4697,4637,60,22,38,4637,3406,1231
"0039C","39-C","140","4210103903000","42","101",21386,21386,19935,1445,6,29700,5776,5915,5915,5766,149,74,75,5766,3656,2110
"0039D","39-D","140","4210103904000","42","101",17107,17107,17070,18,19,32550,4288,4329,4329,4276,53,24,29,4276,3121,1155
"0039E","39-E","140","4210103905000","42","101",6017,6017,5862,142,13,34590,1571,1602,1602,1566,36,11,25,1566,1315,251
"0039F","39-F","140","4210103906000","42","101",107,107,103,2,2,0,11,11,11,11,0,0,0,11,2,9
"0039G","39-G","140","4210103907000","42","101",3,3,3,0,0,0,2,0,0,0,0,0,0,0,0,0
"0039H","39-H","140","4210103908000","42","101",236,236,234,2,0,0,57,59,59,59,0,0,0,59,52,7
"0039I","39-I","140","4210103909000","42","101",80,80,80,0,0,0,22,22,22,22,0,0,0,22,17,5
"0039J","39-J","140","4210103910000","42","101",118,118,118,0,0,0,28,29,29,28,1,0,1,28,6,22
"0039K","39-K","140","4210103911000","42","101",3909,3909,3720,169,20,13320,83,85,85,83,2,0,2,83,0,83
"0040A","40-A","140","4210104001000","42","101",479,479,30,449,0,0,117,123,123,122,1,0,1,122,59,63
"0040B","40-B","140","4210104002000","42","101",9059,9059,6067,2982,10,27970,2370,2423,2423,2372,51,18,33,2372,1350,1022
"0040C","40-C","140","4210104003000","42","101",5200,5200,5197,0,3,36730,1520,1551,1551,1519,32,22,10,1519,947,572
"0040D","40-D","140","4210104004000","42","101",9732,9732,9726,4,2,36700,3026,3038,3038,3013,25,12,13,3013,2133,880
"0040E","40-E","140","4210104005000","42","101",12846,12846,12830,10,6,34680,3452,3465,3465,3447,18,7,11,3447,2798,649
"0040F","40-F","140","4210104006000","42","101",8448,8448,8432,16,0,34090,2291,2380,2380,2297,83,62,21,2297,1774,523
"0040G","40-G","140","4210104007000","42","101",2115,2115,2115,0,0,33930,513,513,513,513,0,0,0,513,0,513
"0040H","40-H","140","4210104008000","42","101",1019,1019,1019,0,0,0,234,233,233,233,0,0,0,233,198,35
"0040I","40-I","140","4210104009000","42","101",10180,10180,10174,4,2,36520,2501,2516,2516,2494,22,13,9,2494,1972,522
"0040J","40-J","140","4210104010000","42","101",6035,6035,6034,1,0,38210,1636,1650,1650,1630,20,14,6,1630,1183,447
"0040K","40-K","140","4210104011000","42","101",5744,5744,5314,430,0,32500,1451,1459,1459,1446,13,3,10,1446,1164,282
"0040L","40-L","140","4210104012000","42","101",13676,13676,13668,7,1,34560,3746,3761,3761,3729,32,14,18,3729,3005,724
"0040M","40-M","140","4210104013000","42","101",22,22,21,1,0,0,6,6,6,6,0,0,0,6,0,6
"0040N","40-N","140","4210104014000","42","101",8192,8192,8142,48,2,39240,2130,2154,2154,2127,27,3,24,2127,1800,327
"0040O","40-O","140","4210104015000","42","101",3906,3906,3179,722,5,25970,859,854,854,848,6,4,2,848,450,398
"0040P","40-P","140","4210104016000","42","101",2851,2851,2788,63,0,34090,693,696,696,683,13,1,12,683,516,167
"0040Q","40-Q","140","4210104017000","42","101",1985,1985,1344,635,6,31250,443,463,463,446,17,13,4,446,344,102
"0040R","40-R","140","4210104018000","42","101",58,58,58,0,0,0,13,13,13,13,0,0,0,13,3,10
"0040S","40-S","140","4210104019000","42","101",133,133,95,28,10,0,0,0,0,0,0,0,0,0,0,0
"0040T","40-T","140","4210104020000","42","101",0,0,0,0,0,0,0,0,0,0,0,0,0,0,0,0
"0040U","40-U","140","4210104021000","42","101",2511,2511,1051,1442,18,27140,593,606,606,587,19,7,12,587,374,213
"0040V","40-V","140","4210104022000","42","101",2114,2114,1411,698,5,28130,507,507,507,504,3,1,2,504,379,125
"0040W","40-W","140","4210104023000","42","101",1087,1087,443,641,3,0,210,217,217,215,2,0,2,215,148,67
"0040X","40-X","140","4210104024000","42","101",1771,1771,801,963,7,23750,417,423,423,416,7,1,6,416,305,111
"0040Y","40-Y","140","4210104025000","42","101",687,687,490,197,0,0,164,165,165,162,3,0,3,162,114,48
"0040Z","40-Z","140","4210104026000","42","101",2,2,0,2,0,0,1,0,0,0,0,0,0,0,0,0
"0040AA","40-AA","140","4210104027000","42","101",0,0,0,0,0,0,0,0,0,0,0,0,0,0,0,0
"0040BB","40-BB","140","4210104028000","42","101",5,5,5,0,0,0,1,0,0,0,0,0,0,0,0,0
"0041A","41-A","140","4210104101000","42","101",105,105,105,0,0,0,9,9,9,9,0,0,0,9,6,3
"0041B","41-B","140","4210104102000","42","101",536,536,535,1,0,0,128,135,135,132,3,2,1,132,123,9
"0041C","41-C","140","4210104103000","42","101",601,601,599,2,0,0,156,167,167,159,8,1,7,159,144,15
"0041D","41-D","140","4210104104000","42","101",125,125,125,0,0,0,34,35,35,34,1,0,1,34,23,11
"0041E","41-E","140","4210104105000","42","101",2324,2324,1299,1025,0,0,244,248,248,244,4,0,4,244,206,38
"0041F","41-F","140","4210104106000","42","101",31,31,6,25,0,0,7,7,7,7,0,0,0,7,1,6
"0041G","41-G","140","4210104107000","42","101",4172,4172,3734,437,1,38440,1130,1203,1203,1134,69,61,8,1134,854,280
"0041H","41-H","140","4210104108000","42","101",10193,10193,10172,17,4,38640,2786,2820,2820,2796,24,15,9,2796,2408,388
"0041I","41-I","140","4210104109000","42","101",9398,9398,9329,68,1,37110,2547,2580,2580,2550,30,12,18,2550,2077,473
"0041J","41-J","140","4210104110000","42","101",5634,5634,5633,0,1,39830,1626,1723,1723,1624,99,87,12,1624,1389,235
"0041K","41-K","140","4210104111000","42","101",5625,5625,5619,2,4,40560,1579,1611,1611,1575,36,18,18,1575,1299,276
"0041L","41-L","140","4210104112000","42","101",4420,4420,4417,2,1,34870,1296,1323,1323,1303,20,7,13,1303,1001,302
"0041M","41-M","140","4210104113000","42","101",3498,3498,3496,0,2,38800,993,1024,1024,991,33,4,29,991,810,181
"0041N","41-N","140","4210104114000","42","101",6155,6155,6141,4,10,33940,1767,1815,1815,1771,44,29,15,1771,1272,499
"0041O","41-O","140","4210104115000","42","101",563,563,563,0,0,0,117,119,119,119,0,0,0,119,84,35
"0041P","41-P","140","4210104116000","42","101",227,227,213,14,0,0,53,56,56,53,3,0,3,53,45,8
"0041Q","41-Q","140","4210104117000","42","101",1246,1246,1020,222,4,0,226,230,230,226,4,3,1,226,147,79
"0041R","41-R","140","4210104118000","42","101",920,920,811,107,2,0,6,5,5,5,0,0,0,5,0,5
"0041S","41-S","140","4210104119000","42","101",958,958,538,419,1,0,1,0,0,0,0,0,0,0,0,0
"0041T","41-T","140","4210104120000","42","101",5,5,5,0,0,0,3,0,0,0,0,0,0,0,0,0
"0041U","41-U","140","4210104121000","42","101",604,604,604,0,0,0,158,169,169,158,11,0,11,158,86,72
"0041V","41-V","140","4210104122000","42","101",308,308,305,3,0,0,62,63,63,62,1,0,1,62,43,19
"0042A","42-A","140","4210104201000","42","101",1497,1497,1495,0,2,39550,456,474,474,458,16,5,11,458,381,77
"0042B","42-B","140","4210104202000","42","101",6203,6203,6200,1,2,37300,1833,1850,1850,1835,15,5,10,1835,1484,351
"0042C","42-C","140","4210104203000","42","101",2045,2045,2038,7,0,40710,607,616,616,601,15,11,4,601,396,205
"0042D","42-D","140","4210104204000","42","101",3911,3911,3893,14,4,36630,1234,1226,1226,1212,14,3,11,1212,688,524
"0042E","42-E","140","4210104205000","42","101",8440,8440,8435,4,1,43090,2592,2609,2609,2590,19,9,10,2590,2242,348
"0042F","42-F","140","4210104206000","42","101",10982,10982,10969,12,1,44920,3319,3395,3395,3339,56,33,23,3339,2873,466
"0042G","42-G","140","4210104207000","42","101",2908,2908,2904,3,1,40790,868,892,892,866,26,12,14,866,679,187
"0042H","42-H","140","4210104208000","42","101",2274,2274,2272,1,1,44600,755,821,821,733,88,82,6,733,411,322
"0042I","42-I","140","4210104209000","42","101",271,271,271,0,0,0,88,91,91,89,2,0,2,89,84,5
"0042J","42-J","140","4210104210000","42","101",218,218,217,1,0,0,57,68,68,57,11,2,9,57,48,9
"0042K","42-K","140","4210104211000","42","101",3190,3190,3188,1,1,49030,1007,1073,1073,989,84,63,21,989,833,156
"0042L","42-L","140","4210104212000","42","101",7229,7229,7224,4,1,47500,2111,2197,2197,2116,81,56,25,2116,1864,252
"0042M","42-M","140","4210104213000","42","101",6135,6135,6126,3,6,35780,1731,1742,1742,1729,13,4,9,1729,1400,329
"0042N","42-N","140","4210104214000","42","101",9012,9012,9001,9,2,39850,2644,2649,2649,2623,26,10,16,2623,2187,436
"0042O","42-O","140","4210104215000","42","101",1756,1756,1716,33,7,50830,475,479,479,476,3,0,3,476,385,91
"0042P","42-P","140","4210104216000","42","101",4192,4192,4192,0,0,36850,1224,1231,1231,1219,12,2,10,1219,1021,198
"0042Q","42-Q","140","4210104217000","42","101",6959,6959,6950,4,5,36250,2215,2238,2238,2203,35,16,19,2203,1603,600
"0042R","42-R","140","4210104218000","42","101",3474,3474,3473,1,0,37970,1121,1124,1124,1117,7,5,2,1117,974,143
"0042S","42-S","140","4210104219000","42","101",4059,4059,4041,15,3,35830,1257,1274,1274,1262,12,10,2,1262,879,383
"0042T","42-T","140","4210104220000","42","101",5044,5044,5032,8,4,36670,1594,1598,1598,1586,12,6,6,1586,1062,524
"0042U","42-U","140","4210104221000","42","101",6980,6980,6303,671,6,31630,1888,1917,1917,1892,25,8,17,1892,1526,366
"0042V","42-V","140","4210104222000","42","101",6482,6482,6478,4,0,38530,1999,2018,2018,1988,30,20,10,1988,1305,683
"0042W","42-W","140","4210104223000","42","101",3383,3383,3372,11,0,41360,1216,1219,1219,1198,21,6,15,1198,598,600
"0042X","42-X","140","4210104224000","42","101",143,143,143,0,0,0,17,21,21,17,4,0,4,17,10,7
"0042Y","42-Y","140","4210104225000","42","101",4284,4284,4258,21,5,39060,1227,1256,1256,1230,26,16,10,1230,974,256
"0042Z","42-Z","140","4210104226000","42","101",3642,3642,3635,0,7,36920,1128,1153,1153,1121,32,24,8,1121,855,266
"0042AA","42-AA","140","4210104227000","42","101",8013,8013,8010,2,1,35880,2411,2447,2447,2417,30,9,21,2417,1825,592
"0042BB","42-BB","140","4210104228000","42","101",4588,4588,4583,4,1,38570,1390,1423,1423,1390,33,4,29,1390,998,392
"0042CC","42-CC","140","4210104229000","42","101",0,0,0,0,0,0,0,0,0,0,0,0,0,0,0,0
"0042DD","42-DD","140","4210104230000","42","101",9284,9284,9277,3,4,34740,2632,2660,2660,2637,23,17,6,2637,2193,444
"0042EE","42-EE","140","4210104231000","42","101",5851,5851,5851,0,0,33490,1818,1836,1836,1809,27,15,12,1809,1361,448
"0042FF","42-FF","140","4210104232000","42","101",2677,2677,2677,0,0,35880,795,798,798,786,12,8,4,786,601,185
"0042GG","42-GG","140","4210104233000","42","101",8285,8285,8277,3,5,38040,2372,2376,2376,2337,39,16,23,2337,1915,422
"0042HH","42-HH","140","4210104234000","42","101",10071,10071,10032,19,20,36070,3286,3304,3304,3278,26,15,11,3278,2013,1265
"0042II","42-II","140","4210104235000","42","101",4927,4927,4906,7,14,35660,1444,1467,1467,1457,10,4,6,1457,1142,315
"0042JJ","42-JJ","140","4210104236000","42","101",2016,2016,2015,1,0,36610,556,556,556,555,1,0,1,555,472,83
"0042KK","42-KK","140","4210104237000","42","101",4130,4130,4121,1,8,32590,1191,1203,1203,1182,21,10,11,1182,920,262
"0043A","43-A","140","4210104301000","42","101",7638,7638,7625,1,12,33170,2342,2346,2346,2329,17,10,7,2329,1871,458
"0043B","43-B","140","4210104302000","42","101",6410,6410,6081,324,5,30440,1885,1906,1906,1880,26,7,19,1880,1200,680
"0043C","43-C","140","4210104303000","42","101",6069,6069,5726,340,3,29340,1798,1832,1832,1802,30,14,16,1802,1032,770
"0043D","43-D","140","4210104304000","42","101",16448,16448,16263,179,6,31980,4737,4803,4803,4736,67,34,33,4736,3339,1397
"0043E","43-E","140","4210104305000","42","101",10819,10819,10816,2,1,30240,3211,3277,3277,3203,74,19,55,3203,2215,988
"0044A","44-A","140","4210104401000","42","101",12405,12405,9962,2435,8,27320,3162,3205,3205,3152,53,18,35,3152,1702,1450
"0044B","44-B","140","4210104402000","42","101",15168,15168,4070,11082,16,20310,3562,3628,3628,3580,48,13,35,3580,1814,1766
"0044C","44-C","140","4210104403000","42","101",13979,13979,4069,9881,29,23590,4003,4105,4105,4039,66,27,39,4039,2472,1567
"0045A","45-A","140","4210104501000","42","101",3166,3166,3164,2,0,31970,814,835,835,815,20,6,14,815,651,164
"0045B","45-B","140","4210104502000","42","101",34,34,30,4,0,0,0,0,0,0,0,0,0,0,0,0
"0045C","45-C","140","4210104503000","42","101",5922,5922,5921,1,0,34020,1545,1572,1572,1551,21,12,9,1551,1356,195
"0045D","45-D","140","4210104504000","42","101",489,489,487,1,1,0,140,148,148,142,6,0,6,142,109,33
"0045E","45-E","140","4210104505000","42","101",1265,1265,1265,0,0,0,327,336,336,333,3,1,2,333,180,153
"0045F","45-F","140","4210104506000","42","101",1927,1927,1910,10,7,36250,571,593,593,581,12,5,7,581,459,122
"0045G","45-G","140","4210104507000","42","101",8548,8548,8533,7,8,31740,2470,2509,2509,2481,28,12,16,2481,1804,677
"0045H","45-H","140","4210104508000","42","101",2804,2804,2739,65,0,30100,742,765,765,747,18,8,10,747,573,174
"0045I","45-I","140","4210104509000","42","101",7656,7656,7637,17,2,33650,2005,2017,2017,2004,13,7,6,2004,1711,293
"0045J","45-J","140","4210104510000","42","101",1049,1049,1012,36,1,0,275,281,281,274,7,0,7,274,207,67
"0045K","45-K","140","4210104511000","42","101",338,338,338,0,0,0,104,107,107,103,4,4,0,103,81,22
"0046A","46-A","140","4210104601000","42","101",9813,9813,9534,269,10,32790,3736,3767,3767,3716,51,30,21,3716,763,2953
"0046B","46-B","140","4210104602000","42","101",11356,11356,10335,972,49,26730,3531,3596,3596,3515,81,48,33,3515,1841,1674
"0046C","46-C","140","4210104603000","42","101",8110,8110,7306,790,14,32260,2276,2282,2282,2263,19,13,6,2263,1505,758
"0046D","46-D","140","4210104604000","42","101",14305,14305,14255,26,24,32780,4365,4474,4474,4396,78,46,32,4396,2882,1514
"0046E","46-E","140","4210104605000","42","101",10802,10802,10788,7,7,37600,2980,3010,3010,2978,32,19,13,2978,2382,596
"0046F","46-F","140","4210104606000","42","101",13066,13066,13034,26,6,33210,3434,3435,3435,3414,21,17,4,3414,2745,669
"0046G","46-G","140","4210104607000","42","101",6756,6756,6744,4,8,34190,2096,2150,2150,2096,54,21,33,2096,1353,743
"0046H","46-H","140","4210104608000","42","101",7221,7221,7189,30,2,31460,2373,2350,2350,2334,16,3,13,2334,913,1421
"0046I","46-I","140","4210104609000","42","101",6777,6777,6588,173,16,28350,2676,2783,2783,2708,75,37,38,2708,667,2041
"0046J","46-J","140","4210104610000","42","101",0,0,0,0,0,0,0,0,0,0,0,0,0,0,0,0
"0047A","47-A","140","4210104701000","42","101",17201,17201,5263,11902,36,18560,5762,5998,5998,5745,253,147,106,5745,816,4929
"0047B","47-B","140","4210104702000","42","101",5768,5768,123,5628,17,17690,1629,1674,1674,1633,41,27,14,1633,309,1324
"0047C","47-C","140","4210104703000","42","101",10670,10670,2408,8253,9,13910,2467,2543,2543,2469,74,30,44,2469,554,1915
"0047D","47-D","140","4210104704000","42","101",3055,3055,1146,1907,2,13520,822,852,852,825,27,6,21,825,124,701
"0048A","48-A","140","4210104801000","42","101",16570,16570,16540,10,20,34550,4255,4289,4289,4251,38,17,21,4251,3379,872
"0048B","48-B","140","4210104802000","42","101",5774,5774,5639,130,5,31170,1429,1437,1437,1426,11,8,3,1426,578,848
"0048C","48-C","140","4210104803000","42","101",4786,4786,4772,9,5,38450,1286,1302,1302,1285,17,6,11,1285,788,497
"0048D","48-D","140","4210104804000","42","101",3681,3681,2734,931,16,20100,834,842,842,835,7,5,2,835,122,713
"0048E","48-E","140","4210104805000","42","101",986,986,972,2,12,0,243,249,249,245,4,3,1,245,0,245
"0048F","48-F","140","4210104806000","42","101",3,3,3,0,0,0,1,0,0,0,0,0,0,0,0,0
